448 449 452 454 455 456 472 473 489 490 493 495 845 846 849 851 854 940 942 951 1042 1044 1189 1190 1191 1259 1260 1262 1267 1271 1276 1277 1280 1282 1289 1290
1493 1494 1501 1502 1506 1507 1508 1509 1511 1514 1517 1519 1522 1523 1524 1525 1529 1530 1532
413 414 422 424 425 426 845 846 858 860 864 940 942 951 1077 1079 1189 1190 1191 1245 1246 1247 1259 1260 1262 1267 1271 1276 1277 1280 1282 1289 1290 1493 1494 1535 1539 1540 1541 1542 1543 1544 1548 1552 1553 1555 1563 1564 1565 1566 1568 1569
69 70 71 72 77 78 80 82 83 84 85 90 93 97 98 99 100 101 106 112 113 114 120 153 155 158 160 684 685 686 687 688 705 707 708 709 712 713 715 717 726 727 732 733 738 739 742 743 744 748 749 750 754 772 773 776 778 779 780 781 783 804 812 813 816 817 818 819 940 942 951 972 973 976 977 980 981 988 989 990 992 995 996 997 999 1002 1003 1006 1007 1113 1114 1115 1116 1117 1118 1120 1123 1124 1131 1219 1220 1221 1222 1259 1260 1262 1267 1271 1272 1273 1276 1280 1282 1289 1290
413 414 417 419 845 846 849 851 854 940 942 951 1077 1079 1189 1190 1191 1245 1246 1247 1259 1260 1262 1267 1271 1276 1277 1280 1282 1289 1290 1493 1494 1501 1502 1506 1507 1508 1509 1511 1514 1517 1519 1522 1523 1524 1525 1529 1530 1532
69 70 71 72 77 78 80 82 83 84 85 90 93 97 98 99 100 101 106 112 113 114 120 153 155 158 160
448 449 452 454 455 456 472 473 845 846 849 851 854 940 942 951 1030 1032 1189 1190 1191 1259 1260 1262 1267 1271 1276 1277 1280 1282 1289 1290
69 70 71 72 73 77 78 80 82 83 84 85 90 93 94 97 98 99 100 101 106 112 113 114 115 116 117 120 179 180 183 184 187 188 191 192 193 194 209 211 214 216 220 222 223 251 252 260 262 263 264 265 266 267 268 269 643 644 647 649 654 684 685 686 687 688 691 693 697 700 702 720 721 722 772 773 776 778 779 780 781 804 940 942 951 972 973 976 977 988 989 990 992 1002 1003 1113 1114 1115 1116 1117 1118 1120 1123 1124 1131 1161 1162 1163 1164 1199 1200 1201 1259 1260 1262 1263 1264 1267 1271 1272 1273 1276 1280 1282 1289 1290
69 70 71 72 73 77 78 80 82 83 84 85 90 93 97 98 99 100 101 112 113 114 115 116 117 120 179 180 183 184 187 188 191 192 193 194 209 211 214 216 220 222 223 251 252 260 262 263 264 265 266 267 268 269 643 644 647 649 654 684 685 686 687 688 691 693 697 700 702 720 721 722 772 773 776 778 779 780 781 804 940 942 951 972 973 976 977 988 989 990 992 1002 1003 1113 1114 1115 1116 1117 1118 1120 1123 1124 1131 1161 1162 1163 1164 1199 1200 1201 1259 1260 1262 1263 1264 1267 1271 1272 1273 1276 1280 1282 1289 1290
69 70 71 72 73 77 78 80 82 83 84 85 90 93 97 98 99 100 101 112 113 114 115 116 117 120 179 180 183 184 187 188 191 192 193 194 209 211 214 216 220 222 223 251 252 260 262 263 264 265 266 267 268 269 643 644 647 649 650 651 654 684 685 686 687 688 691 693 697 700 702 720 721 722 772 773 776 778 779 780 781 804 940 942 951 972 973 976 977 988 989 990 992 1002 1003 1113 1114 1115 1116 1117 1118 1120 1123 1124 1131 1161 1162 1163 1164 1199 1200 1201 1250 1251 1252 1259 1260 1262 1263 1264 1267 1271 1272 1273 1276 1280 1282 1289 1290
69 70 71 72 77 78 80 82 83 84 85 112 113 114 120 209 211 214 216 217 251 252 260 262 263 264 643 644 684 685 686 687 688 691 693 697 700 720 721 722 772 773 776 778 779 780 781 804 940 942 951 972 973 976 977 988 989 990 992 1002 1003 1113 1114 1115 1116 1117 1118 1120 1123 1124 1131 1161 1162 1163 1164 1199 1200 1201 1259 1260 1262 1263 1264 1267 1271 1272 1273 1276 1280 1282 1289 1290
1493 1494 1501 1502 1506 1507 1508 1509 1511 1514 1517 1519 1522 1523 1524 1525 1529 1530 1532
69 70 71 72 77 78 80 82 83 84 85 90 93 97 98 99 100 101 106 112 113 114 120 179 180 183 184 187 188 191 192 193 194 209 211 214 216 220 222 223 251 252 260 262 263 264 265 266 267 268 269 643 644 647 649 654 684 685 686 687 688 691 693 697 700 702 720 721 722 772 773 776 778 779 780 781 804 940 942 951 972 973 976 977 988 989 990 992 1002 1003 1113 1114 1115 1116 1117 1118 1120 1123 1124 1131 1161 1162 1163 1164 1199 1200 1201 1259 1260 1262 1263 1264 1267 1271 1272 1273 1276 1280 1282 1289 1290
1493 1494 1497 1498 1535 1539 1540 1541 1542 1543 1544 1548 1549 1563 1564 1565 1566 1568 1569
1405 1406 1407 1410 1412 1413 1414 1416 1419 1421 1422 1459 1460 1587 1588 1591 1593 1623 1624 1627 1637 1638
684 685 686 687 688 691 693 697 700 702 705 707 708 709 712 715 717 720 721 722 726 727 728 732 733 738 739 742 743 744 748 749 750 754 772 773 776 778 779 780 781 783 804 940 942 951 972 973 976 977 980 981 988 989 990 992 995 996 997 999 1002 1003 1113 1114 1115 1116 1117 1118 1120 1123 1124 1131 1161 1162 1163 1164 1259 1260 1262 1267 1271 1272 1273 1276 1280 1282 1289 1290
890 891 892 895 897 898 899 900 902 908 910 913 914 915 916 917 919 920 940 942 943 944 945 946 948 951 1259 1260 1262 1267 1271 1276 1280 1282 1289 1290 1587 1588 1591 1593 1623 1624 1627 1637 1638 1641 1643 1644 1646 1648
448 449 452 454 455 456 472 473 489 490 493 495 845 846 849 851 854 940 942 951 1042 1044 1189 1190 1191 1259 1260 1262 1267 1271 1276 1277 1280 1282 1289 1290
69 70 71 72 73 77 78 80 82 83 84 85 90 93 94 97 98 99 100 101 106 112 113 114 115 116 117 120 179 180 183 184 187 188 191 192 193 194 209 211 214 216 220 222 223 251 252 260 262 263 264 265 266 267 268 269 643 644 647 649 654 684 685 686 687 688 691 693 697 700 702 720 721 722 772 773 776 778 779 780 781 783 804 940 942 951 972 973 976 977 988 989 990 992 1002 1003 1113 1114 1115 1116 1117 1118 1120 1123 1124 1125 1126 1131 1161 1162 1163 1164 1199 1200 1201 1259 1260 1262 1263 1264 1267 1271 1272 1273 1276 1280 1282 1289 1290
69 70 71 72 73 77 78 80 82 83 84 85 90 93 94 97 98 99 100 101 106 112 113 114 115 116 117 120 133 135 138 140 526 527 530 532 533 535 536 544 545 546 549 551 555 557 558 559 560 562 563 588 593 940 942 951 1209 1210 1211 1259 1260 1262 1267 1268 1271 1276 1280 1282 1289 1290 1350 1351 1371 1372 1373 1374 1375 1377 1378 1379 1380 1382
448 449 452 454 455 456 472 473 845 846 849 851 854 940 942 951 1030 1032 1189 1190 1191 1259 1260 1262 1267 1271 1276 1277 1280 1282 1289 1290
890 891 892 895 897 898 899 900 902 908 910 913 914 915 916 917 919 920 940 942 943 944 945 946 948 951 1259 1260 1262 1267 1271 1276 1280 1282 1289 1290 1587 1588 1591 1593 1623 1624 1627 1637 1638 1641 1643 1644 1646 1648
1493 1494 1497 1498 1501 1502 1503 1514 1517 1519 1522 1523 1524 1525 1529 1530 1532
69 70 71 72 73 77 78 80 82 83 84 85 90 93 94 97 98 99 100 101 106 112 113 114 115 116 117 120 133 135 138 140 526 527 530 532 533 535 536 544 545 546 549 551 555 557 558 559 560 562 563 564 565 569 570 571 574 578 588 590 593 940 942 951 1209 1210 1211 1259 1260 1262 1267 1268 1271 1276 1280 1282 1289 1290 1350 1351 1354 1355 1356 1357 1358 1359 1364 1365 1368 1371 1372 1373 1374 1375 1377 1378 1379 1380 1382
69 70 71 72 77 78 80 82 83 84 85 90 93 97 98 99 100 101 106 112 113 114 120 153 155 158 160 684 685 686 687 688 691 693 694 697 700 702 720 721 772 773 776 778 779 780 781 783 804 808 809 816 817 818 819 940 942 951 972 973 976 977 988 989 990 992 1002 1003 1006 1007 1113 1114 1115 1116 1117 1118 1120 1123 1124 1131 1219 1220 1221 1222 1259 1260 1262 1267 1271 1272 1273 1276 1280 1282 1289 1290
413 414 422 424 425 426 845 846 858 860 864 940 942 951 1077 1079 1189 1190 1191 1245 1246 1247 1259 1260 1262 1267 1271 1276 1277 1280 1282 1289 1290 1493 1494 1535 1539 1540 1541 1542 1543 1544 1548 1552 1553 1555 1563 1564 1565 1566 1568 1569
684 685 686 687 688 691 693 697 700 702 705 707 708 709 712 715 717 720 721 726 727 732 733 738 739 742 743 744 745 748 749 750 752 754 772 773 776 778 779 780 781 783 804 940 942 951 972 973 976 977 980 981 984 985 988 989 990 992 995 996 997 999 1002 1003 1113 1114 1115 1116 1117 1118 1120 1123 1124 1131 1144 1145 1146 1147 1259 1260 1262 1267 1271 1272 1273 1276 1280 1282 1289 1290
448 449 452 454 455 458 489 490 845 846 849 851 854 940 942 951 1068 1070 1189 1190 1191 1259 1260 1262 1267 1271 1276 1277 1280 1282 1289 1290
1493 1494 1497 1498 1535 1539 1540 1548 1552 1553 1559 1563 1564 1565 1568 1569
413 414 448 449 489 490 845 846 1030 1032 1042 1044 1055 1057 1068 1070 1077 1079 1189 1190 1191 1259 1260 1262 1267 1271 1276 1277 1280 1282 1289 1290 1493 1494
1405 1406 1407 1410 1412 1413 1414 1416 1419 1421 1422 1432 1434 1435 1436 1437 1438 1439 1440 1441 1449 1455 1456 1459 1460 1587 1588 1591 1593 1623 1624 1627 1637 1638
448 449 462 464 465 466 476 477 845 846 858 860 864 940 942 951 1030 1032 1189 1190 1191 1259 1260 1262 1267 1271 1276 1277 1280 1282 1289 1290
448 449 452 454 455 458 845 846 849 851 854 940 942 951 1055 1057 1189 1190 1191 1259 1260 1262 1267 1271 1276 1277 1280 1282 1289 1290
684 685 686 687 688 691 693 697 700 702 705 707 708 709 712 715 717 720 721 726 727 732 733 734 738 739 742 743 744 748 749 750 754 772 773 776 778 779 780 781 783 804 940 942 951 972 973 976 977 980 981 988 989 990 992 995 996 997 999 1002 1003 1113 1114 1115 1116 1117 1118 1120 1123 1124 1131 1178 1179 1180 1181 1259 1260 1262 1267 1271 1272 1273 1276 1280 1282 1289 1290
21 22 30 32 35 36 37 38 41 42 69 70 71 72 77 78 80 82 83 84 85 90 93 97 98 99 100 101 106 112 113 114 120 133 135 138 140 684 685 686 687 688 691 693 697 700 702 720 721 722 772 773 776 778 779 780 781 783 804 940 942 951 972 973 976 977 988 989 990 992 1002 1003 1113 1114 1115 1116 1117 1118 1120 1123 1124 1131 1161 1162 1163 1164 1233 1235 1236 1259 1260 1262 1267 1271 1272 1273 1276 1280 1282
1405 1406 1407 1410 1412 1413 1414 1416 1419 1421 1422 1459 1460 1587 1588 1591 1593 1623 1624 1627 1637 1638
413 414 448 449 489 490 845 846 858 860 861 862 940 942 951 1030 1032 1042 1044 1055 1057 1068 1070 1077 1079 1189 1190 1191 1259 1260 1262 1267 1271 1276 1277 1280 1282 1289 1290 1493 1494
1493 1494 1497 1498 1535 1539 1540 1548 1552 1553 1555 1563 1564 1565 1568 1569
890 891 892 895 897 898 899 900 902 908 910 913 914 915 916 917 919 920 940 942 943 944 945 946 948 951 1259 1260 1262 1267 1271 1276 1280 1282 1289 1290 1587 1588 1591 1593 1623 1624 1627 1637 1638 1641 1643 1644 1646 1648
940 942 951 1259 1260 1262 1267 1271 1276 1280 1282 1289 1290
448 449 462 464 465 466 476 477 489 490 498 500 845 846 858 860 864 940 942 951 1042 1044 1189 1190 1191 1259 1260 1262 1267 1271 1276 1277 1280 1282 1289 1290
890 891 892 895 897 898 899 900 902 908 910 913 914 915 916 917 919 920 940 942 943 944 945 946 951 1259 1260 1262 1267 1271 1276 1280 1282 1289 1290 1587 1588 1591 1593 1623 1624 1627 1637 1638 1641 1643 1644 1646 1648
1405 1406 1407 1410 1412 1413 1414 1416 1419 1421 1422 1432 1434 1435 1436 1437 1438 1439 1440 1441 1449 1455 1456 1459 1460 1587 1588 1591 1593 1623 1624 1627 1637 1638
1493 1494 1497 1498 1535 1539 1540 1548 1552 1553 1555 1563 1564 1565 1568 1569
1405 1406 1407 1410 1412 1413 1414 1416 1432 1434 1435 1436 1437 1449 1459 1460 1587 1588 1591 1593 1623 1624 1627 1637 1638
413 414 417 419 845 846 849 851 854 940 942 951 1077 1079 1189 1190 1191 1245 1246 1247 1259 1260 1262 1267 1271 1276 1277 1280 1282 1289 1290 1493 1494 1501 1502 1506 1507 1508 1509 1511 1514 1517 1519 1522 1523 1524 1525 1529 1530 1532
1493 1494 1497 1498 1501 1502 1503 1514 1517 1519 1522 1523 1529 1530 1532
