97 98 99 100 101 113 114 115 116 124 130 131 136 137 138 139 140 158 159 160 161 162 210 211 212 213 214 215 296 297 298 299 300 301 302 303
97 98 99 100 101 113 114 115 116 120 121 124 130 131 136 137 138 139 140 158 159 160 162 210 211 212 213 214 215 304 305 306 307 308 309 310 311 312
1238 1239 1240 1241 1242 1243 1245 1246 1247 1264 1265 1266 1267
97 98 99 100 101 107 108 109 110 113 114 115 116 124 130 131 161 162 186 187 188 189 190 191 210 211 212 213 214 215
97 98 99 100 101 113 114 115 116 124 125 126 131 161 162 210 211 212 213 214 215 395 396 397 398 399
92 93 94 95 97 98 99 100 101 109 110 113 114 115 116 124 130 131 133 134 161 162 198 199 200 201 202 203 210 211 212 213 214 215 838 839 840 841 845 846 847 860 1292 1294 1295 1310 1311 1312 1313 1314 1315 1365
0 97 98 99 100 101 102 103 104 105 106 109 110 113 114 115 116 117 119 124 127 128 129 131 132 135 144 145 146 147 148 149 150 151 152 153 155 156 157 162 319 327 328 329 330 331 332 333 334 335 336 337 338 339 340 341 342 343 344 345 346 347 348 349 350 382 383 384 385 386 1368 1369 1370 1371 1372 1373 1374 1382 1383 1384 1385
97 98 99 100 101 102 103 104 105 106 111 112 113 114 115 116 119 124 125 126 131 158 159 160 162 210 211 212 213 214 215 216 217 218 219 220 221 222 223 224 225
1 14 15 16 17 18 19 20 21 22 23 24 27 28 29 30 31 32 33 35 36 37 38 39 40 41 45 46 47 48 49 65 66 67 68 85 86 87 88 89 91 92 93 94 95 455 479 481 482 483 484 485 486 487 488 489 490 501 502 503 504 505 506 507 508 509 510 544 587 588 589 590 591 592 593 594 595 596 597 598 599 600 601 602 603 604 605 606 607 608 609 610 611 665 666 667 668 735 736 737 738 745 746 747 748 749 750 751 752 753 754 755 756 757 758 759 760 761 762 763 764 765 773 774 775 776 777 778 779 780 787 788 789 790 791 792 793 794 795 796 797 798 799 800 803 804 809 810 811 812 815 818 819 820 821 822 823 824 825 826 827 828 829 830 831 832 833 834 835 836 837 849 850 851 852 853 854 855 856 857 861 862 889 890 891 892 893 894 895 1017 1018 1019 1021 1022 1024 1174 1175 1176 1310 1311 1312 1313 1314 1315 1316 1317 1318 1319 1320 1321 1322 1323 1334 1335 1336 1337 1338 1339 1340 1341 1342 1343 1410 1411 1412 1413 1414 1415 1425 1426 1427 1428 1429 1430 1431 1432 1433 1434 1435 1436 1437 1438 1439 1440 1441 1442 1443 1444 1445 1446 1447 1448 1449 1450 1451 1452 1453 1454 1455 1456 1457 1458 1459 1460 1461 1462 1467 1468 1469 1470 1471 1472 1473 1474 1475 1476 1477 1478 1479 1480 1481 1482 1483 1484 1485 1486 1487 1488 1489 1490 1491 1492 1493 1494 1495 1496 1497 1498 1499 1500 1501 1502 1503 1504 1505
97 98 99 100 101 109 110 113 114 115 116 120 121 124 127 128 129 131 161 162 210 211 212 213 214 215 426 427 428 429 430 431 432 433 434 435
69 70 71 72 73 74 75 76 77 78 735 736 737 738 1074 1075 1076 1077 1078 1079 1084 1085 1139 1140 1141 1172 1173 1279 1280 1281 1282 1283 1305 1306 1307 1308 1309 1368
1 14 15 16 17 18 19 20 21 22 23 24 25 26 27 28 29 30 31 32 33 34 35 36 37 38 39 42 43 44 45 46 47 48 49 455 698 699 715 716 717 718 719 727 728 729 730 731 732 733 734 735 736 737 738 739 787 788 789 790 791 792 793 794 795 796 797 798 799 800 889 890 891 892 893 894 895 896 897 898 899 900 908 909 910 911 912 913 914 915 973 974 975 976 977 978 979 980 981 982 983 984 1017 1018 1019 1020 1024 1066 1067 1068 1074 1075 1076 1077 1078 1079 1080 1081 1083 1089 1090 1091 1092 1093 1094 1174 1292 1293 1294 1295 1310 1311 1312 1313 1314 1315 1334 1335 1336 1337 1338 1339 1340 1341 1342 1344 1345 1346 1347 1348 1349 1350 1351 1352 1353 1354 1355 1356 1357 1358 1359 1360 1361 1362 1363 1364 1410 1411 1412 1413 1414 1415 1416 1417 1418 1419 1420 1422 1423 1424 1425 1426 1427 1428 1440 1441 1442 1443 1444 1445 1446 1447 1448 1449 1450 1451 1452 1453 1454 1455 1456 1457 1458 1462 1463 1464 1465 1466 1479 1480 1481 1482 1483 1484 1485 1486 1487 1488 1489 1490 1491 1492 1493 1496 1497 1498 1499 1500 1501 1502 1503 1504 1505
96 97 98 99 100 101 109 110 113 114 115 116 124 127 128 129 131 161 162 444 445 446 447 448
72 73 74 75 76 77 78 80 81 82 83 84 735 736 737 738 1017 1018 1019 1021 1022 1024 1025 1026 1066 1067 1068 1069 1070 1071 1072 1074 1075 1076 1077 1078 1079 1080 1081 1082 1084 1086 1087 1089 1090 1091 1092 1093 1094 1095 1096 1097 1098 1099 1128 1129 1130 1131 1132 1133 1134 1135 1136 1137 1138 1139 1140 1141 1142 1143 1144 1145 1146 1147 1148 1149 1150 1151 1152 1153 1154 1155 1282 1283 1288 1289 1290 1291 1305 1306 1307 1308 1309 1368
0 97 98 99 100 101 102 103 104 105 106 109 110 113 114 115 116 117 119 124 127 128 129 131 132 135 144 145 147 148 149 150 151 152 153 155 156 157 158 159 160 162 319 351 352 353 354 355 356 357 358 359 360 361 362 363 364 365 366 367 368 369 370 371 372 373 374 382 383 384 385 386 1368 1369 1370 1371 1372 1373 1374 1382 1383 1384 1385
735 736 737 738 739 886 1017 1018 1019 1020 1073 1074 1075 1076 1077 1078 1079 1083 1177 1185 1186 1187 1188 1189 1190 1191 1192
97 98 99 100 101 113 114 115 116 120 121 124 130 131 136 137 138 139 140 158 159 160 161 162 163 164 165 166 167 168 169 170 171 210 211 212 213 214 215
1368 1369 1370 1371 1372 1373 1374 1375 1376 1377 1378 1379 1380 1381 1382 1383 1384 1385 1386 1506 1507 1508 1509 1510 1511 1512 1513 1514 1515 1516 1517 1518 1519 1520 1521 1522 1523 1524 1525 1526 1527 1528 1529 1530 1531 1532 1533 1534 1535 1536 1537 1538 1539 1540
0 2 5 6 97 98 99 100 101
916 917 918 943 944 973 974 975 976 977 978 979 980 981 982 983 984 1310 1311 1312 1313 1314 1315 1344 1345 1346 1347 1348 1349 1350 1351 1352 1353 1354 1355 1356 1357 1358 1359 1360 1361 1362 1363 1364
0 97 98 99 100 101 102 103 104 105 106 109 110 113 114 115 116 117 119 120 121 124 125 126 127 128 129 131 135 144 145 147 148 149 150 151 152 153 154 155 156 157 162 320 321 322 323 324 325 326 382 383 384 385 386 1368 1369 1370 1371 1372 1373 1374 1382 1383
1368 1392 1398 1399 1400 1401
1238 1239 1240 1241 1242 1243 1245 1246 1247 1268 1269 1270
1 14 15 16 17 18 19 20 21 22 23 24 27 28 29 30 31 32 33 35 36 37 38 39 42 43 44 45 46 47 48 49 455 698 699 715 716 717 718 719 720 721 722 723 724 725 726 735 736 737 738 739 787 788 789 790 791 792 793 794 795 796 797 798 799 800 889 890 891 892 893 894 895 896 897 898 899 900 908 909 910 911 912 913 914 915 973 974 975 976 977 978 979 980 981 982 983 984 1017 1018 1019 1020 1024 1174 1292 1293 1294 1295 1310 1311 1312 1313 1314 1315 1334 1335 1336 1337 1338 1339 1340 1341 1342 1344 1345 1346 1347 1348 1349 1350 1351 1352 1353 1354 1355 1356 1357 1358 1359 1360 1361 1362 1363 1364 1410 1411 1412 1413 1414 1415 1416 1417 1418 1419 1420 1422 1423 1424 1425 1426 1427 1428 1440 1441 1442 1443 1444 1445 1446 1447 1448 1449 1450 1451 1452 1453 1454 1455 1456 1457 1458 1462 1463 1464 1465 1466 1479 1480 1481 1482 1483 1484 1485 1486 1487 1488 1489 1490 1491 1492 1493 1496 1497 1498 1499 1500 1501 1502 1503 1504 1505
1 12 14 15 16 17 18 19 20 21 22 23 24 25 26 27 28 29 30 31 32 33 34 35 36 37 38 39 45 46 47 48 49 72 73 74 75 76 77 78 79 455 465 466 467 468 469 481 482 483 484 485 486 487 488 489 490 669 670 671 672 673 674 675 676 677 678 679 680 681 682 683 684 694 695 696 697 735 736 737 738 745 746 747 748 749 781 782 783 787 788 789 790 791 792 793 794 795 796 797 798 799 800 811 812 815 816 817 818 820 821 822 823 824 825 826 827 828 829 830 831 832 833 834 835 836 837 849 850 851 852 853 854 855 856 857 861 862 889 890 891 892 893 894 895 1017 1018 1019 1021 1022 1024 1066 1067 1068 1069 1071 1074 1075 1076 1077 1078 1079 1080 1081 1082 1084 1086 1087 1089 1090 1091 1092 1093 1094 1174 1175 1176 1282 1283 1284 1285 1292 1293 1294 1295 1305 1306 1307 1308 1309 1310 1311 1312 1313 1314 1315 1316 1317 1318 1319 1320 1321 1322 1323 1334 1335 1336 1337 1338 1339 1340 1341 1342 1368 1410 1411 1412 1413 1414 1415 1425 1426 1427 1428 1429 1430 1431 1432 1433 1434 1435 1436 1437 1438 1439 1440 1441 1442 1443 1444 1445 1446 1447 1448 1449 1450 1451 1452 1453 1454 1455 1456 1457 1458 1459 1460 1461 1462 1463 1464 1465 1466 1467 1468 1469 1470 1471 1479 1480 1481 1482 1483 1484 1485 1486 1487 1488 1489 1490 1491 1492 1493 1494 1495 1496 1497 1498 1499 1500 1501 1502 1503 1504 1505
113 114 115 116 124 125 126 127 128 129 130 131 465 466 467 468 469 484 485 486 1198 1207 1208 1209 1210 1282 1283 1284 1286 1287 1305 1306 1307 1308 1309 1316 1317 1318 1319 1320 1321 1322 1323 1368
97 98 99 100 101 102 103 104 105 106 109 110 113 114 115 116 117 119 124 127 128 129 131 132 135 162 172 173 174 175 176 177 178 179 180 181 182 183 184 185 465 466 467 468 469 470 471 472 473 474 480 481 482 483 484 485 486 1282 1283 1284 1286 1287 1296 1297 1298 1305 1306 1307 1308 1309 1310 1311 1312 1313 1314 1315 1316 1317 1318 1319 1320 1321 1322 1323 1368
0 97 98 99 100 101 102 103 104 105 106 109 110 113 114 115 116 117 119 124 127 128 129 131 132 135 162 254 255 256 257 258 259 260 261 262 263 264 265 266 267 268 269 270 271 272 273 319 382 383 384 385 386 1368
97 98 99 100 101 113 114 115 116 124 127 130 131 133 134 161 162 204 205 206 207 208 209 210 211 212 213 214 215
72 73 74 75 76 77 78 80 81 82 83 84 735 736 737 738 740 741 742 743 744 1017 1018 1019 1021 1022 1023 1027 1028 1029 1035 1036 1037 1038 1039 1282 1283 1305 1306 1307 1308 1309 1368
97 98 99 100 101 109 110 113 114 115 116 124 127 128 129 131 161 162 210 211 212 213 214 215 406 407 408 409 410 411
72 73 74 75 76 77 78 80 81 82 83 84 735 736 737 738 1017 1018 1019 1021 1022 1027 1028 1029 1030 1031 1032 1033 1034 1282 1283 1305 1306 1307 1308 1309 1368
0 1 2 7 8 9 14 15 16 17 18 19 20 21 22 23 24 97 98 99 100 101 455 1174
72 73 74 75 76 77 78 80 81 82 83 84 735 736 737 738 1017 1018 1019 1021 1022 1024 1066 1067 1068 1069 1071 1074 1075 1076 1077 1078 1079 1080 1081 1082 1084 1086 1087 1089 1090 1091 1092 1093 1094 1128 1129 1130 1131 1135 1136 1137 1138 1139 1140 1141 1156 1157 1158 1159 1160 1161 1162 1163 1164 1165 1282 1283 1305 1306 1307 1308 1309 1368
97 98 99 100 101 113 114 115 116 120 121 124 125 126 131 161 162 210 211 212 213 214 215 274 275 276 277 278 279
97 98 99 100 101 107 108 109 110 113 114 115 116 124 130 131 161 162 210 211 212 213 214 215 232 233 234 235 236 237
113 114 115 116 124 125 126 127 128 129 130 131 465 466 467 468 469 481 482 483 484 485 486 1198 1217 1218 1219 1282 1283 1284 1286 1287 1305 1306 1307 1308 1309 1316 1317 1318 1319 1320 1321 1322 1323 1368
916 917 918 947 948 994 995 996 997 998 999 1000 1001 1002 1003 1004 1005 1006 1007 1354 1355 1356 1357 1358 1359 1360 1361 1362 1363 1364
916 917 918 945 946 949 950 951 952 953 954 955 956 957 958 959 960 961 962 963 964 965 966 985 986 987 988 989 990 991 992 993 1008 1009 1010 1011 1012 1013 1014 1015 1016 1354 1355 1356 1357 1358 1359 1360 1361 1362 1363 1364
887 888 889 890 891 892 893 894 895 896 897 898 899 900 901 902 903 906 907 908 909 910 911 912 913 914 915 916 917 918 927 928 929 930 931 967 968 969 970 971 972 1040 1041 1042 1043 1044 1045 1046 1048 1049 1050 1051 1052 1053 1054 1055 1056 1057 1058 1292 1293 1294 1295 1310 1311 1312 1313 1314 1315 1344 1345 1346 1347 1348 1349 1350 1351 1352 1353 1354 1355 1356 1357 1358 1359 1360 1361 1362 1363 1364 1365 1366 1367
887 888 889 890 891 892 893 894 895 896 897 898 899 900 908 909 910 911 912 913 914 915 916 917 918 923 924 925 926 973 974 975 976 977 978 979 980 981 982 983 984 1059 1060 1061 1062 1063 1064 1065 1292 1293 1294 1295 1310 1311 1312 1313 1314 1315 1344 1345 1346 1347 1348 1349 1350 1351 1352 1353 1354 1355 1356 1357 1358 1359 1360 1361 1362 1363 1364
465 466 467 468 469 475 476 477 478 735 736 737 738 1017 1018 1019 1021 1022 1024 1025 1026 1066 1067 1068 1069 1070 1071 1072 1074 1075 1076 1077 1078 1079 1080 1081 1082 1084 1086 1087 1089 1090 1091 1092 1093 1094 1095 1096 1097 1098 1099 1100 1101 1102 1103 1104 1105 1106 1107 1108 1109 1110 1111 1112 1113 1114 1115 1128 1129 1130 1131 1132 1133 1134 1135 1136 1137 1138 1282 1283 1288 1289 1290 1291 1305 1306 1307 1308 1309 1368
12 465 466 467 468 469 484 485 486 487 488 489 490 785 786 787 788 789 790 791 792 793 794 795 796 797 798 799 800 801 802 811 812 815 816 817 818 820 825 826 827 828 829 830 831 832 833 834 835 836 837 838 839 840 841 845 848 849 850 851 852 853 854 856 857 861 862 863 864 865 866 867 868 876 877 878 879 880 881 1040 1041 1042 1043 1047 1048 1049 1050 1051 1052 1053 1054 1055 1056 1057 1058 1174 1175 1176 1282 1283 1284 1285 1292 1293 1294 1295 1305 1306 1307 1308 1309 1310 1311 1312 1313 1314 1315 1316 1317 1318 1319 1320 1321 1322 1323 1368
113 114 115 116 124 125 126 127 128 129 130 131 465 466 467 468 469 484 485 486 1198 1220 1221 1222 1223 1224 1225 1226 1227 1282 1283 1284 1286 1287 1299 1300 1301 1302 1303 1304 1305 1306 1307 1308 1309 1316 1317 1318 1319 1320 1321 1322 1323 1368
0 97 98 99 100 101 113 116 120 121 141 161 162 210 211 212 213 214 215 387 388 389 390
12 465 466 467 468 469 484 485 486 487 488 489 490 785 786 787 788 789 790 791 792 793 794 795 796 797 798 799 800 801 802 811 812 815 816 817 818 820 825 826 827 828 829 830 831 832 833 834 835 836 837 838 839 840 841 845 846 847 848 849 850 851 852 853 854 856 857 861 862 863 864 872 873 874 875 876 877 878 879 880 881 1040 1041 1042 1043 1047 1048 1049 1050 1051 1052 1053 1054 1055 1056 1057 1058 1174 1175 1176 1282 1283 1284 1285 1292 1293 1294 1295 1305 1306 1307 1308 1309 1310 1311 1312 1313 1314 1315 1316 1317 1318 1319 1320 1321 1322 1323 1365 1366 1367 1368
1 2 3 4 14 15 16 17 18 19 20 21 22 23 24 455 1174
1228 1229 1230 1231 1232 1233 1234 1235 1238 1239 1240 1241 1242 1243 1245 1246 1247 1255 1256 1257 1258 1259
1 14 15 16 17 18 19 20 21 22 23 24 25 26 27 28 29 30 31 32 33 34 35 36 37 38 39 42 43 44 45 46 47 48 49 455 698 699 707 708 709 710 711 712 713 714 715 716 717 718 719 735 736 737 738 739 787 788 789 790 791 792 793 794 795 796 797 798 799 800 889 890 891 892 893 894 895 896 897 898 899 900 908 909 910 911 912 913 914 915 967 968 969 970 971 972 1017 1018 1019 1020 1024 1066 1067 1068 1074 1075 1076 1077 1078 1079 1080 1081 1083 1089 1090 1091 1092 1093 1094 1174 1292 1293 1294 1295 1310 1311 1312 1313 1314 1315 1334 1335 1336 1337 1338 1339 1340 1341 1342 1344 1345 1346 1347 1348 1349 1350 1351 1352 1353 1354 1355 1356 1357 1358 1359 1360 1361 1362 1363 1364 1410 1411 1412 1413 1414 1415 1416 1417 1418 1419 1420 1422 1423 1424 1425 1426 1427 1428 1440 1441 1442 1443 1444 1445 1446 1447 1448 1449 1450 1451 1452 1453 1454 1455 1456 1457 1458 1462 1463 1464 1465 1466 1479 1480 1481 1482 1483 1484 1485 1486 1487 1488 1489 1490 1491 1492 1493 1496 1497 1498 1499 1500 1501 1502 1503 1504 1505
97 98 99 100 101 107 108 109 110 113 114 115 116 124 130 131 161 162 210 211 212 213 214 215 226 227 228 229 230 231 858 859
97 98 99 100 101 113 114 115 116 124 130 131 136 137 138 139 140 158 159 160 161 162 210 211 212 213 214 215 288 289 290 291 292 293 294 295
887 888 889 890 891 892 893 894 895 896 897 898 899 900 908 909 910 911 912 913 914 915 916 917 918 919 920 921 922 967 968 969 970 971 972 1059 1060 1061 1062 1063 1064 1065 1292 1293 1294 1295 1310 1311 1312 1313 1314 1315 1344 1345 1346 1347 1348 1349 1350 1351 1352 1353 1354 1355 1356 1357 1358 1359 1360 1361 1362 1363 1364
887 888 889 890 891 892 893 894 895 896 897 898 901 902 903 904 905 906 907 908 909 910 911 912 913 914 915 916 917 918 937 938 939 940 1040 1041 1042 1043 1044 1045 1046 1048 1049 1050 1051 1052 1053 1054 1055 1056 1057 1058 1292 1293 1294 1295 1344 1345 1354 1355 1356 1365 1366 1367 1387 1389 1390 1391
1 10 13 14 15 16 17 18 19 20 21 22 23 24 27 28 29 30 31 32 33 35 36 37 38 39 40 41 45 46 47 48 49 50 51 52 53 54 55 56 57 58 59 60 61 62 63 64 65 66 67 68 72 73 74 75 76 77 78 79 85 86 87 88 89 90 91 92 93 94 95 454 455 456 457 458 459 460 461 462 463 464 465 466 467 468 469 511 512 513 514 515 516 517 539 540 541 542 543 544 568 569 570 571 572 573 574 575 576 577 578 579 580 581 582 583 584 585 586 665 666 667 668 735 736 737 738 745 746 747 748 749 750 751 752 753 754 755 756 757 758 759 760 761 762 764 765 773 774 777 778 779 780 781 782 783 784 787 788 789 790 791 792 793 794 795 796 797 798 799 800 803 804 810 811 812 815 816 817 818 820 821 822 823 824 825 826 827 828 829 830 831 832 833 834 835 836 837 849 850 851 852 853 854 855 856 857 861 862 889 890 891 892 893 894 895 1017 1018 1019 1021 1022 1024 1174 1175 1176 1282 1283 1284 1285 1292 1293 1294 1295 1305 1306 1307 1308 1309 1310 1311 1312 1313 1314 1315 1324 1325 1326 1327 1328 1329 1330 1331 1332 1333 1334 1335 1336 1337 1338 1339 1340 1341 1342 1343 1368 1410 1411 1412 1413 1414 1415 1421 1423 1424 1425 1426 1427 1428 1429 1430 1431 1432 1433 1434 1435 1436 1437 1438 1439 1440 1441 1442 1443 1444 1445 1446 1447 1448 1449 1450 1451 1452 1453 1454 1455 1456 1457 1458 1459 1460 1461 1462 1467 1468 1469 1470 1471 1472 1473 1474 1475 1476 1477 1478 1479 1480 1481 1482 1483 1484 1485 1486 1487 1488 1489 1490 1491 1492 1493 1494 1495 1496 1497 1498 1499 1500 1501 1502 1503 1504 1505
735 736 737 738 739 1017 1018 1019 1020 1177 1178 1179 1180 1181 1182 1183 1184
0 97 98 99 100 101 113 114 115 116 122 123 124 125 126 131 161 162 210 211 212 213 214 215 391 392 393 394
1282 1283 1284 1285 1305 1306 1307 1308 1309 1310 1311 1312 1313 1314 1315 1392 1393 1394 1395 1396 1397
465 466 467 468 469 475 476 477 478 735 736 737 738 1017 1018 1019 1021 1022 1024 1066 1067 1068 1069 1071 1074 1075 1076 1077 1078 1079 1080 1081 1082 1084 1086 1087 1089 1090 1091 1092 1093 1094 1100 1101 1116 1117 1118 1119 1120 1121 1122 1123 1124 1125 1128 1129 1130 1131 1135 1136 1137 1138 1282 1283 1305 1306 1307 1308 1309 1368
0 97 98 99 100 101 111 112 113 114 115 116 118 124 125 126 131 161 162 210 211 212 213 214 215 400 401 402 403 404 405
97 98 99 100 101 109 110 113 114 115 116 120 121 124 127 128 129 131 161 162 210 211 212 213 214 215 238 239 240 241 242 243 244 245
72 73 74 75 76 77 78 80 81 82 83 84 735 736 737 738 740 741 742 743 744 1017 1018 1019 1021 1022 1024 1066 1067 1068 1069 1071 1074 1075 1076 1077 1078 1079 1080 1081 1082 1084 1086 1087 1088 1089 1090 1091 1092 1093 1094 1128 1129 1130 1131 1135 1136 1137 1138 1139 1140 1141 1156 1157 1158 1159 1166 1167 1168 1169 1170 1171 1282 1283 1305 1306 1307 1308 1309 1368
97 98 99 100 101 107 108 109 110 113 114 115 116 124 130 131 162 210 211 212 213 214 215 313 314 315 316 317 318
1 14 15 16 17 18 19 20 21 22 23 24 27 28 29 30 31 32 33 35 36 37 38 39 40 41 45 46 47 48 49 65 66 67 68 85 86 87 88 89 91 92 93 94 95 455 531 532 533 534 535 536 537 538 544 545 546 547 548 549 550 551 552 553 554 555 556 557 558 559 560 561 562 563 564 565 566 567 665 666 667 668 735 736 737 738 745 746 747 748 749 750 751 752 753 754 755 756 757 758 759 760 763 764 766 767 768 769 770 771 772 773 774 775 776 777 778 779 787 788 789 790 791 792 793 794 795 796 797 798 799 800 803 804 805 806 807 808 809 810 811 812 813 814 815 818 819 820 821 822 823 824 825 826 827 828 829 830 831 832 833 834 835 836 837 849 850 851 852 853 854 855 856 857 861 862 889 890 891 892 893 894 895 1017 1018 1019 1021 1022 1024 1174 1175 1176 1310 1311 1312 1313 1314 1315 1334 1335 1336 1337 1338 1339 1340 1341 1342 1343 1410 1411 1412 1413 1414 1415 1425 1426 1427 1428 1429 1430 1431 1432 1433 1434 1435 1436 1437 1438 1439 1440 1441 1442 1443 1444 1445 1446 1447 1448 1449 1450 1451 1452 1453 1454 1455 1456 1457 1458 1459 1460 1461 1462 1467 1468 1469 1470 1471 1472 1473 1474 1475 1476 1477 1478 1479 1480 1481 1482 1483 1484 1485 1486 1487 1488 1489 1490 1491 1492 1493 1494 1495 1496 1497 1498 1499 1500 1501 1502 1503 1504 1505
97 98 99 100 101 102 103 104 105 106 107 108 109 110 113 114 115 116 117 119 124 130 131 135 144 145 147 148 149 150 151 152 153 155 156 157 161 162 436 437 438 439 440 441 442 443 1368 1369 1370 1371 1372 1373 1374 1382 1383 1384 1385
887 888 889 890 891 892 893 894 895 896 897 898 899 900 901 902 903 906 907 908 909 910 911 912 913 914 915 916 917 918 932 933 934 935 936 967 968 969 970 971 972 1040 1041 1042 1043 1044 1045 1046 1048 1049 1050 1051 1052 1053 1054 1055 1056 1057 1058 1292 1293 1294 1295 1310 1311 1312 1313 1314 1315 1344 1345 1346 1347 1348 1349 1350 1351 1352 1353 1354 1355 1356 1357 1358 1359 1360 1361 1362 1363 1364 1365 1366 1367
11 465 466 467 468 469 487 488 489 490 785 786 787 788 789 790 791 792 793 794 795 796 797 798 799 800 801 802 825 827 828 829 830 838 839 840 841 842 843 844 845 846 847 848 850 851 852 853 854 856 857 861 862 863 864 869 870 871 876 877 878 1040 1041 1042 1043 1047 1048 1049 1050 1051 1052 1053 1054 1055 1056 1057 1058 1174 1175 1176 1282 1283 1284 1285 1292 1293 1294 1295 1305 1306 1307 1308 1309 1310 1311 1312 1313 1314 1315 1365 1366 1367 1368 1387 1388
1 14 15 16 17 18 19 20 21 22 23 24 25 26 27 28 29 30 31 32 33 34 35 36 37 38 39 40 41 45 46 47 48 49 65 66 67 68 85 86 87 88 89 91 92 93 94 95 455 481 482 483 484 486 487 488 489 490 518 519 520 521 522 523 524 525 526 527 528 529 530 544 638 639 640 641 642 643 644 645 646 647 648 649 650 651 652 653 654 655 656 657 658 659 660 661 662 663 664 665 666 667 668 735 736 737 738 745 746 747 748 749 750 751 752 753 754 755 756 757 758 759 760 763 764 766 767 768 769 770 771 772 773 774 775 776 777 778 779 780 787 788 789 790 791 792 793 794 795 796 797 798 799 800 803 804 805 806 807 808 809 810 811 812 813 814 815 818 819 820 821 822 823 824 825 826 827 828 829 830 831 832 833 834 835 836 837 849 850 851 852 853 854 855 856 857 861 862 889 890 891 892 893 894 895 1017 1018 1019 1021 1022 1024 1066 1067 1068 1069 1071 1074 1075 1076 1077 1078 1079 1080 1081 1082 1084 1086 1087 1089 1090 1091 1092 1093 1094 1174 1175 1176 1310 1311 1312 1313 1314 1315 1334 1335 1336 1337 1338 1339 1340 1341 1342 1343 1410 1411 1412 1413 1414 1415 1425 1426 1427 1428 1429 1430 1431 1432 1433 1434 1435 1436 1440 1441 1442 1443 1444 1445 1446 1447 1448 1449 1450 1451 1452 1453 1454 1455 1456 1457 1458 1460 1461 1462 1467 1468 1469 1470 1471 1472 1473 1474 1475 1476 1477 1478 1479 1480 1481 1482 1483 1484 1485 1486 1487 1488 1489 1490 1491 1492 1493 1494 1495 1496 1497 1498 1499 1500 1501 1502 1503 1504 1505
97 98 99 100 101 109 110 111 112 113 114 115 116 124 127 128 129 131 162 210 211 212 213 214 215 419 420 421 422 423 424 425
97 98 99 100 101 109 110 113 114 115 116 124 127 128 129 131 161 162 449 450 451 452 453
1 14 15 16 17 18 19 20 21 22 23 24 27 28 29 30 31 32 33 35 36 37 38 39 40 41 45 46 47 48 49 65 66 67 68 85 86 87 88 89 90 91 92 93 94 95 455 491 492 493 494 495 496 497 498 499 500 544 612 613 614 615 616 617 618 619 620 621 622 623 624 625 626 627 628 629 630 631 632 633 634 635 636 637 665 666 667 668 735 736 737 738 745 746 747 748 749 750 751 752 753 754 755 756 757 758 759 760 761 762 763 764 765 773 774 775 776 777 778 779 780 787 788 789 790 791 792 793 794 795 796 797 798 799 800 803 804 809 810 811 812 815 818 819 820 821 822 823 824 825 826 827 828 829 830 831 832 833 834 835 836 837 849 850 851 852 853 854 855 856 857 861 862 889 890 891 892 893 894 895 1017 1018 1019 1021 1022 1024 1174 1175 1176 1310 1311 1312 1313 1314 1315 1324 1325 1326 1327 1328 1329 1330 1331 1332 1333 1334 1335 1336 1337 1338 1339 1340 1341 1342 1343 1410 1411 1412 1413 1414 1415 1425 1426 1427 1428 1429 1430 1431 1432 1433 1434 1435 1436 1437 1438 1439 1440 1441 1442 1443 1444 1445 1446 1447 1448 1449 1450 1451 1452 1453 1454 1455 1456 1457 1458 1459 1460 1461 1462 1467 1468 1469 1470 1471 1472 1473 1474 1475 1476 1477 1478 1479 1480 1481 1482 1483 1484 1485 1486 1487 1488 1489 1490 1491 1492 1493 1494 1495 1496 1497 1498 1499 1500 1501 1502 1503 1504 1505
916 917 918 941 942 967 968 969 970 971 972 1310 1311 1312 1313 1314 1315 1344 1345 1346 1347 1348 1349 1350 1351 1352 1353 1354 1355 1356 1357 1358 1359 1360 1361 1362 1363 1364
97 98 99 100 101 107 108 109 110 113 114 115 116 120 121 124 125 126 127 128 129 130 131 142 158 159 160 465 466 467 468 469 484 485 486 1193 1194 1195 1196 1197 1198 1199 1200 1201 1202 1203 1204 1205 1206 1282 1283 1284 1286 1287 1305 1306 1307 1308 1309 1316 1317 1318 1319 1320 1321 1322 1323 1368
97 98 99 100 101 102 103 104 105 106 109 110 113 114 115 116 117 119 124 127 128 129 131 132 135 162 210 211 212 213 214 215 375 376 377 378 379 380 381 1368
1238 1239 1243 1244 1245 1246 1247 1275 1276 1277 1278
97 98 99 100 101 113 114 115 116 124 130 131 136 137 138 139 140 158 159 160 161 162 210 211 212 213 214 215 280 281 282 283 284 285 286 287
97 98 99 100 101 109 110 113 114 115 116 120 121 124 127 128 129 131 161 162 210 211 212 213 214 215 246 247 248 249 250 251 252 253
113 114 115 116 124 125 126 127 128 129 130 131 465 466 467 468 469 484 485 486 1198 1211 1212 1213 1214 1215 1216 1282 1283 1284 1286 1287 1299 1300 1301 1302 1303 1304 1305 1306 1307 1308 1309 1316 1317 1318 1319 1320 1321 1322 1323 1368
1 14 15 16 17 18 19 20 21 22 23 24 27 28 29 30 31 32 33 35 36 37 38 39 42 43 44 45 46 47 48 49 455 698 699 700 701 702 703 704 705 706 715 716 717 718 719 735 736 737 738 739 787 788 789 790 791 792 793 794 795 796 797 798 799 800 889 890 891 892 893 894 895 896 897 898 899 900 908 909 910 911 912 913 914 915 967 968 969 970 971 972 1017 1018 1019 1020 1024 1174 1292 1293 1294 1295 1310 1311 1312 1313 1314 1315 1334 1335 1336 1337 1338 1339 1340 1341 1342 1344 1345 1346 1347 1348 1349 1350 1351 1352 1353 1354 1355 1356 1357 1358 1359 1360 1361 1362 1363 1364 1410 1411 1412 1413 1414 1415 1416 1417 1418 1419 1420 1422 1423 1424 1425 1426 1427 1428 1440 1441 1442 1443 1444 1445 1446 1447 1448 1449 1450 1451 1452 1453 1454 1455 1456 1457 1458 1462 1463 1464 1465 1466 1479 1480 1481 1482 1483 1484 1485 1486 1487 1488 1489 1490 1491 1492 1493 1496 1497 1498 1499 1500 1501 1502 1503 1504 1505
1 12 14 15 16 17 18 19 20 21 22 23 24 27 28 29 30 31 32 33 35 36 37 38 39 45 46 47 48 49 455 481 482 483 484 486 487 488 489 490 674 685 686 687 688 689 690 691 692 693 694 695 696 697 735 736 737 738 745 746 747 748 749 787 788 789 790 791 792 793 794 795 796 797 798 799 800 811 812 815 818 820 821 822 823 824 825 826 827 828 829 830 831 832 833 834 835 836 837 849 850 851 852 853 854 855 856 857 861 862 889 890 891 892 893 894 895 1017 1018 1019 1021 1022 1024 1174 1175 1176 1310 1311 1312 1313 1314 1315 1334 1335 1336 1337 1338 1339 1340 1341 1342 1410 1411 1412 1413 1414 1415 1425 1426 1427 1428 1429 1430 1431 1432 1433 1434 1435 1436 1437 1438 1439 1440 1441 1442 1443 1444 1445 1446 1447 1448 1449 1450 1451 1452 1453 1454 1455 1456 1457 1458 1459 1460 1461 1462 1463 1464 1465 1466 1467 1468 1469 1470 1471 1479 1480 1481 1482 1483 1484 1485 1486 1487 1488 1489 1490 1491 1492 1493 1494 1495 1496 1497 1498 1499 1500 1501 1502 1503 1504 1505
97 98 99 100 101 107 108 109 110 113 114 115 116 124 130 131 143 161 162 192 193 194 195 196 197 210 211 212 213 214 215
1228 1229 1230 1231 1232 1233 1234 1236 1237 1238 1239 1240 1241 1242 1243 1245 1246 1247 1248 1249 1250 1251 1252 1253 1254
97 98 99 100 101 109 110 111 112 113 114 115 116 124 127 128 129 131 161 162 210 211 212 213 214 215 412 413 414 415 416 417 418
1238 1239 1240 1241 1242 1243 1245 1246 1247 1271 1272 1273 1274
465 466 467 468 469 735 736 737 738 1074 1075 1076 1077 1078 1079 1084 1085 1100 1101 1126 1127 1282 1283 1305 1306 1307 1308 1309 1368
1238 1239 1240 1241 1242 1243 1245 1246 1247 1260 1261 1262 1263
12 465 466 467 468 469 484 485 486 487 488 489 490 785 786 787 788 789 790 791 792 793 794 795 796 797 798 799 800 801 802 811 812 815 816 817 818 820 825 826 827 828 829 830 831 832 833 834 835 836 837 849 850 851 852 853 854 856 857 861 862 863 864 876 877 878 879 880 881 882 883 884 885 1059 1060 1061 1062 1063 1064 1065 1174 1175 1176 1282 1283 1284 1285 1292 1293 1294 1295 1305 1306 1307 1308 1309 1310 1311 1312 1313 1314 1315 1316 1317 1318 1319 1320 1321 1322 1323 1368
1343 1392 1402 1403 1404 1405 1406 1407 1408 1409
