871 872 888 890 1079 1080 1103 1104 1235 1236 1239 1303 1305 1306 1307 1311 1312 1313 1315 1319 1322 1323
237 238 275 277 1111 1112 1274 1275 1276 1277 1278 1281
1135 1136
871 872 898 900 1087 1088 1099 1100 1143 1144 1254 1255 1256 1257 1258 1261 1322 1323
871 872 888 890 1079 1080 1103 1104 1235 1236 1237 1284 1286 1287 1288 1292 1293 1294 1300 1322 1323
237 238
871 872 879 880 1091 1092 1206 1207 1208 1209 1213 1214 1215
237 238 254 256 1079 1080 1103 1104 1235 1236 1237 1284 1286 1287 1288 1292 1293 1294 1296 1300 1322 1323
871 872 903 905 1107 1108 1264 1265 1266 1267 1268 1271
356 357 423 424 871 872 925 926 927 928 929 930 931 944
237 238 280 281 282 283 284 285 289 1439 1440
1079 1080 1107 1108
871 872 879 880 1087 1088 1206 1207 1208 1209 1210 1211
237 238 249 251 1087 1088 1091 1092 1206 1207 1208 1209 1210 1211 1213 1214 1215 1222 1223 1224 1226 1227 1228 1229 1230 1232
237 238 245 246 1091 1092 1206 1207 1208 1209 1213 1214 1215
871 872 883 885 1087 1088 1091 1092 1206 1207 1208 1209 1210 1211 1213 1214 1215 1222 1223 1224 1226 1227 1228 1229 1230 1232
863 864 871 872 947 948 949 950 951 954 970 972 1123 1124 1322 1323 1327 1328 1329 1330 1331 1332 1333 1334 1335 1336 1337 1338 1343
1079 1080 1139 1140
1079 1080 1131 1132
368 369 470 471 478 479 480 482 871 872 957 958 959 960 961 963 967
871 872 888 890 1079 1080 1103 1104 1235 1236 1239 1303 1305 1306 1307 1308 1311 1312 1313 1319 1322 1323
1079 1080 1115 1116
237 238 265 267 1087 1088 1099 1100 1143 1144 1254 1255 1256 1257 1258 1261 1322 1323
237 238 254 256 1079 1080 1103 1104 1235 1236 1239 1303 1305 1306 1307 1308 1311 1312 1313 1319 1322 1323
871 872 888 890 1079 1080 1103 1104 1235 1236 1237 1284 1286 1287 1288 1289 1292 1293 1294 1300 1322 1323
871 872 875 876
871 872 893 895 1087 1088 1095 1096 1243 1244 1245 1246 1247 1248 1251
352 353 387 388 871 872 913 914 915 916 917 918 922
360 361 507 508 511 512 871 872 879 880 1091 1092 1206 1207 1208 1209 1213 1214 1215 1468 1469 1474 1475 1480 1481 1486 1487 1492 1493
237 238 254 256 1079 1080 1103 1104 1235 1236 1239 1303 1305 1306 1307 1308 1311 1312 1313 1315 1319 1322 1323
237 238 292 293 294 295 296 297 301 1443 1444
871 872 888 890 1079 1080 1103 1104 1235 1236 1239 1303 1305 1306 1307 1308 1311 1312 1313 1315 1319 1322 1323
237 238 245 246 1087 1088 1206 1207 1208 1209 1210 1211
237 238 254 256 1079 1080 1103 1104 1235 1236 1237 1284 1286 1287 1288 1292 1293 1294 1300 1322 1323
1079 1080 1127 1128
237 238 260 262 1087 1088 1095 1096 1243 1244 1245 1246 1247 1248 1251
1079 1080 1147 1148
237 238 270 272 1107 1108 1264 1265 1266 1267 1268 1271
229 230 237 238 254 256 304 306 1079 1080 1103 1104 1235 1236 1239 1303 1305 1306 1307 1311 1312 1313 1315 1319 1322 1323 1327 1328 1329 1330 1331 1332 1333 1334 1335 1336 1337 1338 1343
237 238 241 242
