339 340 343 344 1030 1031 1038 1039 1046 1047 1048 1049 1050 1051
2943 2944
3016 3017 3019 3020 3021 3022
3240 3241
7497 7498 7501 7502 7503 7798 7800 8200 8201 8202
4692 4693 4694 4695 4696
481 482 485 486 487 488 489 525 526 527 528 529
3055 3056 3252 3253 3254 3255
1274 1275 1276 1277 1280 1281 1282 1283 1284 1285 1286 1289 1290 1293 1294 2911 2912 2915 2916 2917 2918 2919 2920 2927 2928 2931 2932 6721 6722
834 835 836 837 838 845 846 853 854 1030 1031 1927 1928 1929 3286 3287 4836 4837 4844 4845 4848 4849 4866 4867 5690 5691 5692 5695 5696
2061 2062 2063
6076 6388 6389 6390 6392 6405 6406 6409
2536 2537
834 835 836 837 838 845 846 1030 1031 3286 3287 4836 4837
7501 7502 7503 8200 8201 8202
7497 7498 7501 7502 7503 8089 8090 8092 8093 8094 8095 8099 8104 8113 8114 8115 8117 8121 8122 8129 8130 8131 8132 8200 8201 8202 8241 8242 8245 8246 8247 8669 8670 8672 8679 8680
1927 1928 1929 1940 1941 1942 1943 3323 3324 5690 5691 5692 5695 5696 5703 5704
3175 3176 3177
7501 7502 7503 8200 8201 8202 8241 8242 8245 8246 8247 8371 8372 8375 8376 8377 8378 8379 8429 8430 8431 8432 8433
379 380
4819 4820 4823 4824 5690 5691 5692 5695 5696 5703 5704
3228 3229 3230
7497 7498 7501 7502 7503 7516 7517 7518 7608 7609 7641 7642 7645 7646 8200 8201 8202 8232 8233 8236 8237 8238 8241 8242 8245 8246 8247 8375 8376 8377 8378 8379 8452 8453 8454 8484 8485 8486 8487 8490 8492 8496 8498 8499 8500 8501 8503 8505 8507 8510 8511 8552 8553 8554 8572 8573 8576 8577 8578
2931 2932 2966 2967 2968 3148 3150 3151 3153 3154 3167 3168 3171 3172
2931 2932 2961 2962 2963 2966 2967 2968
3181 3182 3183
2061 2062 2064 2208 2209 2210 2211 2234 2235
203 204 207 208 2855 2856 2857 2858 2873 2874 2875 2877 2879 2881
2701 2702 2703 2704 2706 2708 2710 2711 2712 2713 2714 2716 2718 2720 2722 2741 2742 3286 3287 3346 3347 3348 3349 3368 3369 3372 3373 3380 3381 3384 3385 5573 5574 5577 5578 5581 5582 5589 5590 5651 5652 5690 5691 5692 5695 5696
6125 6126 6129 6130 6166 6167 6170 6171 6174 6175
291 292 295 296 2340 2341 2342 2343 2346 2347 2348 2349 2350 2353 2354 2361 2362 2363 2364 2365 2366
481 482 485 486 487 488 489
3148 3150 3151 3153 3156 3167 3168 3171 3172
7501 7502 7503 7516 7517 7518 8200 8201 8202 8241 8242 8245 8246 8247 8375 8376 8377 8378 8379 8572 8573 8576 8577 8578
3200 3201 3258 3259 3260
7497 7498 7501 7502 7503 7818 7819 8200 8201 8202
227 228 231 232 4692 4693 4694 4695 4715 4716 4717 4719 4721
7501 7502 7503 7516 7517 7518 8200 8201 8202 8245 8246 8247 8375 8376 8377 8378 8379 8448 8449 8572 8573 8576 8577 8578
363 364 1013 1014 1017 1018 1927 1928 1929 5690 5691 5692 5695 5696 5703 5704
5763 5765 5766 5767 5770 5771 5772 5773 5774 5777 5778 5779 5786 5787 5790 5791 5792 5795 5796 7497 7498 7501 7502 7503 7608 7609 7641 7642 7645 7646 8200 8201 8202 8232 8233 8236 8237 8238 8245 8246 8247 8375 8376 8377 8378 8379 8452 8453 8454 8474 8475 8476 8484 8485 8486 8487 8490 8492 8496 8498 8499 8500 8501 8503 8505 8507 8510 8511 8520 8521 8552 8553 8554 8572 8573 8576 8577 8578
7335 7336 7337 7362 7363 7364 7365 7366 7367 7368 7389 7390 7391 7392 7393 7497 7498 7501 7502 7503 7516 7517 7518 8192 8193 8200 8201 8202 8236 8237 8238
2036 2037 2038 2039
7501 7502 7503 7516 7517 7518 8200 8201 8202 8241 8242 8245 8246 8247 8375 8376 8377 8378 8379 8395 8396 8397 8408 8409 8448 8449 8557 8558 8560 8561 8562 8565 8566 8567 8568 8569 8572 8573 8576 8577 8578
315 316 319 320 481 482 525 526 527 529
1927 1928 1929 1940 1941 1942 1943 4764 4765 5690 5691 5692 5695 5696 5703 5704
7501 7502 7503 7779 7780 7781 7782 7783 8200 8201 8202 8241 8242 8245 8246 8247 8375 8376 8377 8378 8379 8421 8422 8572 8573 8576 8577 8578
2624 2625
7497 7498 7501 7502 7503 8089 8090 8091 8200 8201 8202
1927 1928 1929 1940 1941 1942 1943 1952 1953 5690 5691 5692 5695 5696 5703 5704
6125 6126 6129 6130 6166 6167 6170 6171 6174 6175
371 372
7501 7502 7503 7676 7677 7678 7679 7687 7688 7689 7690 7691 8200 8201 8202 8241 8242 8245 8246 8247 8375 8376 8377 8378 8379 8395 8396 8397 8408 8409 8412 8413 8414 8415 8448 8449 8557 8558 8559 8560 8561 8562 8565 8566 8567 8568 8569 8572 8573 8576 8577 8578
2947 2948
7497 7498 7501 7502 7503 7826 7827 8200 8201 8202
834 835 836 837 838 861 862 863 865 866 867 868 869 870 871
2061 2062 2064 2208 2209 2210 2211 2263 2264
2771 2772 2773
5617 5618 5619 5622 5623 5634 5635 5636 5637 5638 5639
323 324 327 328 741 742 745 746 747 762 763 764 775 776 777 778 779 5690 5691 5692 5695 5696 5699 5700 5703 5704 5707 5708
444 445 446 447 4692 4693 4694 4695 4696
444 445 446 447 462 463 464 465 466 4692 4693 4694 4695 4696 4703 4704
2824 2825 2826 2827 2842 2843 3248 3249
359 360 2701 2702 2703 2704 2706 2708 2710 2711 2712 2716 2718 2720 2722 2741 2742 2745 2746 2749 2750
444 445 446 447 2701 2702 2703 2704 2706 2708 2709 2710 2711 2712 2716 2718 2720 2722 2741 2742 3286 3287 3346 3347 3348 3349 3356 3357 3368 3369 3380 3381 4692 4693 4694 4695 4696 4703 4704
7385 7386 7396 7397 7440 7441 7442 7443
3078 3079
7497 7498 7501 7502 7503 7516 7517 7518 8200 8201 8202 8228 8229
7497 7498 7501 7502 7503 8089 8090 8092 8093 8094 8104 8113 8114 8115 8117 8121 8122 8129 8130 8131 8132 8133 8200 8201 8202 8241 8242 8669 8670 8672 8679 8680
6125 6126 6129 6130 6166 6167 6170 6171 6174 6175
1316 1317 1584 1585
7501 7502 7503 8200 8201 8202
2061 2062 2064 2208 2209 2210 2211 2250 2251
444 445 446 447 450 451 1927 1928 1929 3268 3269 3286 3287 3290 3292 3346 3347 3348 3349 3356 3357 3368 3369 3372 3373 3380 3381 3384 3385 4692 4693 4694 4695 4696 4703 4704 5573 5574 5577 5578 5581 5582 5589 5590 5651 5652 5690 5691 5692 5695 5696
7497 7498 7501 7502 7503 7516 7517 7518 8200 8201 8202 8241 8242 8245 8246 8247
1064 1065 1072 1073 1076 1077 1078 1081 1082 1083 1084 1085 1086 1087 1088 1089 1090 1093 1096 1099 1102 1105 1106 1109 1110 1111 1112 1274 1275 1276 1277 1280 1281 1282 1283 1284 1285 1286 1289 1290 1293 1294 1305 1306 1309 1310 1311 1312 1320 1321 1322 1323 1324 1338 1339 1340 1341 1342 1343 1344 1392 1393 1394 1397 1398 1399 1402 1403 1404 1407 1408 1409 1412 1413 1414 1415 1416 1417 1580 1581 1584 1585 1616 1617 1618 1619 6721 6722 7501 7502 7503 8200 8201 8202 8245 8246 8247 8264 8265 8272 8273 8274 8275 8278 8279 8281 8282
2061 2062 2064 2208 2209 2210 2211 2283 2284
7389 7390 7391 7392 7393 7497 7498 7501 7502 7503 7516 7517 7518 8200 8201 8202 8216 8217
2961 2962 2963 2966 2967 2968
2939 2940 2966 2967 2968 3128 3129 3130 3148 3150 3158 3159 3171 3172 8683 8684
3228 3229 3230 3231
7501 7502 7503 8200 8201 8202 8371 8372 8375 8376 8377 8378 8379 8408 8409
307 308 311 312 578 579 580 581 582 609 610 612 613 615 616 617
7501 7502 7503 8200 8201 8202 8371 8372 8375 8376 8377 8378 8379 8444 8445
684 685 686 687 702 703 706 707 710 711 1193 1194 1927 1928 1929 2389 2390 2391 2392 2393 2396 2397 2398 2401 2402 2405 2406 3268 3269 3286 3287 3290 3292 3346 3347 3348 3349 3368 3369 3372 3373 3376 3377 3380 3381 3384 3385 3388 3389 3392 3393 4776 4777 4796 4797 4798 4819 4820 5573 5574 5577 5578 5581 5582 5651 5652 5666 5667 5670 5671 5690 5691 5692 5695 5696 5699 5700 5703 5704 5707 5708
199 200
395 396 5651 5652 5690 5691 5692
2824 2825 2826 2827 2842 2843
29 66 67 70 71 74 75 82 87 88 92 127 128 129 130 131 133
1903 1904 1927 1928 1929 1940 1941 1942 1943 5690 5691 5692 5695 5696 5703 5704
2061 2062 2064 2208 2209 2210 2211 2242 2243
3048 3049 3252 3253 3254 3255
383 384
2771 2772 2773 2776 2777 2784 2785 2786 2787
2340 2341 2342 2343 2346 2347 2348 2349 2350 2353 2354 2361 2362 2363 2364 2365 2366
7335 7336 7337 7338 7342 7343 7344 7347 7353 7354 7355 7356 7357 7358 7359 7362 7363 7364 7365 7366 7367 7368 7389 7390 7391 7392 7393 7497 7498 7501 7502 7503 7506 7507 8140 8141 8192 8193 8200 8201 8202 8205 8206 8207 8209 8212 8213 8220 8221 8224 8225 8228 8229 8236 8237 8238 8241 8242 8371 8372 8375 8376 8377 8378 8379 8683 8684
331 332 335 336 427 428 834 835 836 837 838 861 862 863 865 866 867 868 869 870 871
6125 6126 6133 6134 6135 6136 6139 6140 6141 6142 6144 6147 6148 6151 6152 6155 6156 6157 6158 6159 6160 6161 6163 6166 6167 6170 6171 6174 6175
7497 7498 7501 7502 7503 8200 8201 8202 8220 8221
631 632 635 636 647 648 651 652 653 654 655 656 657
578 579 580 581 582 585 586 589 590 593 594 597 598 1927 1928 1929 1932 1933 3286 3287 3346 3347 3348 3349 3356 3357 3364 3365 3368 3369 3380 3381 4732 4733 4736 4737 5690 5691 5692 5695 5696 5703 5704
2158 2159
3192 3193 3258 3259 3260
251 252 2771 2772 2773 2776 2777 2784 2785 2786 2787
6280 6282 6283 6284 6285 6298 6299
5724 5725 7472 7473 7474 7497 7498 7501 7502 7503 8200 8201 8202
2931 2932 2966 2967 2968 3148 3150 3158 3160 3161 3167 3168 3171 3172
7335 7336 7337 7338 7342 7343 7344 7347 7353 7354 7355 7356 7357 7358 7359 7362 7363 7364 7365 7366 7367 7368 7389 7390 7391 7392 7393 7497 7498 7501 7502 7503 7506 7507 8192 8193 8200 8201 8202 8205 8206 8207 8209 8212 8213 8220 8221 8224 8225 8228 8229 8236 8237 8238 8241 8242 8683 8684
3234 3235 3236 3237
578 579 580 581 582 609 610 612 613 615 616 617
7389 7390 7391 7392 7393 7497 7498 7501 7502 7503 7516 7517 7518 8200 8201 8202 8205 8206 8207 8209 8212 8213 8371 8372 8375 8376 8377 8378 8379 8436 8437 8440 8441 8444 8445
3065 3066
7497 7498 7501 7502 7503 7562 7567 7568 7586 7587 7588 8200 8201 8202
7385 7386 7389 7390 7391 7392 7393 7396 7397
2067 2068
2935 2936 2939 2940 3124 3125 3128 3129 3130 3136 3139
1316 1317 1588 1589
8625 8626 8632 8633 8634 8639 8640 8643 8646 8647 8648 8649 8655
267 268 271 272
149 150 151 152 153 154 170 171 174 175 178 179 182 183 184 187 188 1274 1275 1276 1277 1280 1281 1282 1283 1284 1285 1286 1289 1290 1297 1298 2911 2912 2915 2916 2917 2918 2919 2920 4881 4882 5200 5201 5202 5203 6721 6722
741 742 745 746 747 3286 3287 4776 4777 4796 4797 4798 4801 4802 4803 4804 4805 4807 4819 4820 5690 5691 5692 5695 5696 5699 5700 5703 5704 5707 5708
684 685 686 687 702 703 706 707 710 711 1193 1194 1927 1928 1929 2340 2341 2342 2343 2346 2347 2348 2349 2350 2353 2354 2357 2358 2701 2702 2703 2704 2706 2708 2710 2711 2712 2716 2718 2720 2722 2741 2742 3268 3269 3286 3287 3290 3292 3346 3347 3348 3349 3356 3357 3368 3369 3372 3373 3380 3381 3384 3385 3392 3393 4692 4693 4694 4695 4696 4699 4700 4703 4704 5573 5574 5577 5578 5581 5582 5585 5586 5589 5590 5651 5652 5690 5691 5692 5695 5696 5703 5704
2165 2166 2167
3222 3223 3224 3225
1927 1928 1929 3268 3269 3286 3287 3290 3292 5690 5691 5692 5695 5696 5703 5704
7497 7498 7501 7502 7503 7562 7567 7569 7570 7571 8200 8201 8202
3175 3176 3177 3178
1274 1275 1276 1277 1280 1281 1282 1283 1284 1285 1286 1289 1290 1293 1294 2911 2912 2915 2916 2917 2918 2919 2920 2935 2936 2939 2940 6721 6722
7497 7498 7501 7502 7503 7608 7609 7612 7613 7641 7642 7645 7646 8200 8201 8202 8232 8233 8236 8237 8238 8245 8246 8247 8375 8376 8377 8378 8379 8421 8422 8425 8426 8452 8453 8454 8484 8485 8486 8487 8490 8492 8496 8498 8499 8500 8501 8503 8505 8507 8510 8511 8552 8553 8554 8572 8573 8576 8577 8578
578 579 580 581 582 1918 1919 1920 1921 1922 1923 1924
834 835 836 837 838 845 846 849 850 1013 1014 1030 1031 1038 1039 1042 1043 1927 1928 1929 3286 3287 4836 4837 5690 5691 5692 5695 5696
481 482 485 486 487 488 489 493 494 497 498 505 506 513 514 517 518 540 541 542 545 546 549 550 741 742 745 746 747 1193 1194 1197 1198 1209 1210 2701 2702 2703 2704 2706 2708 2710 2711 2712 2713 2714 2716 2718 2720 2722 2725 2726 2737 2738 2741 2742 3286 3287 4732 4733 4736 4737 4740 4741 4752 4753 4776 4777 4784 4785 4792 4793 4796 4797 4798 4801 4802 4803 4804 4805 4807 5690 5691 5692 5695 5696 5699 5700 5703 5704 5707 5708
7501 7502 7503 7516 7517 7518 8200 8201 8202 8245 8246 8247 8375 8376 8377 8378 8379 8448 8449 8452 8453 8454 8484 8485 8486 8487 8572 8573 8576 8577 8578
2701 2702 2703 2704 2705 2706 2707 2708 2709 2710 2711 2712 2713 2714 2716 2717 2718 2719 2720 2721 2722 2741 2742 2745 2746 3286 3287
684 685 686 687 690 691 710 711 714 715 716 717 718 719 720 721
1030 1031 1038 1039 1046 1047 1048 1049 1050 1051
684 685 686 687 694 695 698 699 710 711 794 795 796 799 800 803 804
4692 4693 4694 4695 4715 4716 4717 4718 4719 4720 4721
3016 3017 3019 3021 3022
387 388 1952 1953
2701 2702 2703 2704 2706 2708 2710 2711 2712 2713 2714 2716 2718 2720 2722 2741 2742 2745 2746 2749 2750
2176 2177
259 260 263 264 3346 3347 3348 3349 3437 3438 3439 3441 3445 3446 3452
2951 2952
444 445 446 447 834 835 836 837 838 841 842 845 846 1030 1031 2701 2702 2703 2704 2706 2708 2710 2711 2712 2716 2718 2720 2722 2741 2742 3286 3287 3346 3347 3348 3349 3356 3357 3368 3369 3380 3381 4692 4693 4694 4695 4696 4703 4704 4836 4837
1927 1928 1929 2855 2856 2857 2858 2861 2862 2865 2866 3286 3287 3346 3347 3348 3349 3356 3357 3368 3369 4692 4693 4694 4695 4696 4732 4733 4736 4737 4836 4837 4840 4841 4844 4845 4848 4849 4866 4867 5690 5691 5692 5695 5696
419 420 5666 5667 5674 5675
481 482 485 486 487 488 489 493 494 497 498 505 506 513 514 517 518 540 541 542 545 546 549 550 741 742 745 746 747 1193 1194 1197 1198 1209 1210 2701 2702 2703 2704 2706 2708 2710 2711 2712 2713 2714 2716 2718 2720 2722 2725 2726 2737 2738 2741 2742 3286 3287 4732 4733 4736 4737 4740 4741 4752 4753 4776 4777 4784 4785 4792 4793 4796 4797 4798 4801 4802 4803 4804 4805 4807 5690 5691 5692 5695 5696 5699 5700 5703 5704 5707 5708
7501 7502 7503 8200 8201 8202 8245 8246 8247 8375 8376 8377 8378 8379 8448 8449 8452 8453 8454 8572 8573 8576 8577 8578 8585 8586 8587 8590 8591
255 256 2797 2798 2801 2802 2809 2810 2811 2812
3196 3197 3258 3259 3260
351 352 5617 5618 5619 5634 5635 5636 5637 5638
1274 1275 1276 1277 1280 1281 1282 1283 1284 1285 1286 1289 1290 1293 1294 2911 2912 2915 2916 2917 2918 2919 2920 2923 2924 6721 6722
7501 7502 7503 8129 8130 8131 8133 8200 8201 8202 8241 8242 8245 8246 8247 8375 8376 8377 8378 8379 8448 8449 8572 8573 8576 8577 8578 8585 8586 8587 8590 8593
1013 1014 1017 1018 1927 1928 1929 5690 5691 5692 5695 5696 5703 5704
6382 6383 6384 6385 6388 6389 6390 6392 6405 6406 6407
2071 2072 2073
7335 7336 7337 7338 7342 7343 7344 7347 7353 7354 7355 7356 7357 7358 7359 7362 7363 7364 7365 7366 7367 7368 7389 7390 7391 7392 7393 7497 7498 7501 7502 7503 7506 7507 8140 8141 8192 8193 8200 8201 8202 8205 8206 8207 8209 8212 8213 8220 8221 8224 8225 8228 8229 8236 8237 8238 8241 8242 8683 8684
7501 7502 7503 7516 7517 7518 8200 8201 8202 8371 8372 8375 8376 8377 8378 8379 8448 8449 8452 8453 8454
149 150 151 152 153 154 170 171 182 183 184 187 188 1274 1275 1276 1277 1280 1281 1282 1283 1284 1285 1286 1289 1290 1293 1294 2911 2912 2915 2916 2917 2918 2919 2920 6721 6722
403 404 1193 1194 1209 1210 1213 1214 5690 5691 5692 5695 5696 5703 5704
2797 2798 2801 2802 2809 2810 2811 2812
283 284 287 288 631 632 647 648 651 652 653 655 657
4732 4733 4736 4737 4740 4741 4752 4753 4756 4757 5690 5691 5692 5695 5696 5703 5704
7501 7502 7503 7676 7677 7678 7679 7687 7688 7689 7690 7691 8200 8201 8202 8241 8242 8245 8246 8247 8375 8376 8377 8378 8379 8395 8396 8397 8408 8409 8412 8413 8414 8415 8448 8449 8557 8558 8560 8561 8562 8565 8566 8567 8568 8569 8572 8573 8576 8577 8578
347 348 684 685 686 687 710 711 714 715 716 717 718 720
411 412 4776 4777 4792 4793 4796 4797 4798 4810 4811 5690 5691 5692 5695 5696 5699 5700 5703 5704 5707 5708
741 742 745 746 747 762 763 764 775 776 777 778 779 5690 5691 5692 5695 5696 5699 5700 5703 5704 5707 5708
5651 5652 5655 5656 5690 5691 5692 5695 5696 5703 5704
7497 7498 7501 7502 7503 7516 7517 7518 8200 8201 8202 8224 8225
2071 2072 2074 2208 2209 2210 2211 2234 2235
444 445 446 447 2701 2702 2703 2704 2706 2708 2710 2711 2712 2713 2714 2716 2718 2720 2722 2741 2742 3286 3287 3346 3347 3348 3349 3356 3357 3368 3369 3380 3381 4692 4693 4694 4695 4696 4703 4704
1274 1275 1276 1277 1280 1281 1282 1283 1284 1285 1286 1289 1290 1293 1294 1301 1302 6721 6722
7501 7502 7503 8200 8201 8202 8371 8372 8375 8376 8377 8378 8379 8382 8383 8384 8385 8390 8391 8401 8402 8403 8405 8408 8409 8448 8449
367 368
299 300 303 304 2389 2390 2391 2392 2393 2396 2397 2398 2401 2402 2409 2410 2411 2412 2413 2414
6382 6383 6384 6385 6388 6389 6390 6392 6405 6406 6407
7497 7498 7501 7502 7503 7608 7609 7641 7642 7645 7646 8200 8201 8202 8232 8233 8236 8237 8238 8245 8246 8247 8375 8376 8377 8378 8379 8452 8453 8454 8484 8485 8486 8487 8490 8492 8496 8498 8499 8500 8501 8503 8505 8507 8510 8511 8544 8545 8552 8553 8554 8572 8573 8576 8577 8578
5738 5739 5740 5741 5742 5743 5746 5747 5750 5751 7497 7498 7501 7502 7503 8200 8201 8202
8241 8242
8625 8626 8632 8633 8634 8639 8640 8643 8646 8647 8648 8649 8655
7497 7498 7501 7502 7503 8129 8130 8131 8132 8200 8201 8202 8241 8242 8245 8246 8247
399 400 741 742 745 746 747 750 751 5690 5691 5692 5695 5696 5699 5700 5703 5704 5707 5708
684 685 686 687 690 691 706 707
149 150 151 152 153 154 170 171 182 183 184 935 936 939 940 941 942 1064 1065 1274 1275 1276 1277 1280 1281 1282 1283 1284 1285 1286 1289 1290 1293 1294 2911 2912 2915 2916 2917 2918 2919 2920 3082 3087 3088 3089 3090 3091 3092 3093 3094 3097 3098 3101 3102 3103 3104 3105 3112 3113 3116 3117 3118 6721 6722
2927 2928 2931 2932 2961 2962 2963 2966 2967 2968 2992 2994
7497 7498 7501 7502 7503 7516 7517 7518 8200 8201 8202 8241 8242
3029 3030
834 835 836 837 838 845 846 849 850 853 854 1013 1014 1030 1031 1038 1039 1042 1043 1927 1928 1929 3286 3287 4836 4837 4844 4845 4848 4849 4866 4867 5690 5691 5692 5695 5696
794 795 796 807 808 809 810 811
7501 7502 7503 8200 8201 8202 8245 8246 8247 8264 8265 8272 8273 8274 8275
2824 2825 2826 2827 2830 2831 2834 2835 2838 2839 3286 3287
423 424 2824 2825 2826 2827 2842 2843
391 392 540 541 542 549 550 553 554 555 556
5573 5574 5577 5578 5585 5586 5593 5594 5595 5596 5597 5598 5599
7497 7498 7501 7502 7503 8200 8201 8202 8371 8372 8375 8376 8377 8378 8379 8436 8437 8444 8445
3346 3347 3348 3349 3368 3369 3372 3373 3376 3377 3437 3438 3439 3440 3441 3442 3445 3446 3447 3448 3449 3450 3452
2939 2940 3124 3125 3128 3129 3130
1927 1928 1929 1940 1941 1942 1943 2440 2441 5690 5691 5692 5695 5696 5703 5704
3286 3287 4732 4733 4736 4737 5690 5691 5692 5695 5696 5703 5704
247 248 1927 1928 1929 4866 4867 4870 4871 5690 5691 5692 5695 5696 5703 5704
355 356 1927 1928 1929 5690 5691 5692
3222 3223 3224
3214 3215 3252 3253 3254 3255 5651 5652 5690 5691 5692
741 742 745 746 747 750 751 5690 5691 5692 5695 5696 5699 5700 5703 5704 5707 5708
1274 1275 1276 1277 1280 1281 1282 1283 1284 1285 1286 1289 1290 1293 1294 1305 1306 1309 1310 1311 1312 1320 1321 1322 1323 1324 1327 1328 1329 1330 1331 1332 1333 1334 1335 1338 1339 1340 1341 1342 1343 1344 1347 1348 1349 1350 1351 1363 1364 1366 1369 1370 1372 1373 1376 1377 1378 1379 1380 1381 1382 1383 1384 1385 1388 1389 1392 1393 1394 1397 1398 1399 1402 1403 1404 1407 1408 1409 1412 1413 1414 1415 1416 1417 1517 1518 1572 1573 1576 1577 1580 1581 1584 1585 1588 1589 1616 1617 1618 1619 6717 6718 6721 6722 7385 7386 7501 7502 7503 7649 7651 7652 7656 7659 7660 7661 7662 8200 8201 8202 8245 8246 8247 8375 8376 8377 8378 8379 8536 8537 8572 8573 8576 8577 8578 8596 8597 8598 8599 8603 8606 8607
3286 3287 4732 4733 4736 4737 5690 5691 5692 5695 5696 5703 5704
2389 2390 2391 2392 2393 2396 2397 2398 2401 2402 2409 2410 2411 2412 2413 2414
631 632 643 644 647 648 794 795 796 799 800 803 804
7501 7502 7503 7516 7517 7518 8200 8201 8202 8371 8372 8375 8376 8377 8378 8379 8448 8449
578 579 580 581 582 585 586 589 590 593 594 1927 1928 1929 1932 1933 2701 2702 2703 2704 2706 2708 2710 2711 2712 2716 2718 2720 2722 2741 2742 3286 3287 3346 3347 3348 3349 3356 3357 3368 3369 3380 3381 5690 5691 5692 5695 5696 5703 5704
375 376
8625 8626 8632 8633 8634 8636 8639 8640 8643 8646 8647 8648 8649 8655
4776 4777 4792 4793 4796 4797 4798 4810 4811 5690 5691 5692 5695 5696 5699 5700 5703 5704 5707 5708
684 685 686 687 694 695 698 699 702 703 706 707 710 711 741 742 745 746 747 794 795 796 799 800 803 804 1193 1194 1927 1928 1929 2340 2341 2342 2343 2346 2347 2348 2349 2350 2353 2354 2357 2358 2701 2702 2703 2704 2706 2708 2710 2711 2712 2716 2718 2720 2722 2741 2742 3268 3269 3286 3287 3290 3292 3346 3347 3348 3349 3356 3357 3368 3369 3372 3373 3380 3381 3384 3385 3392 3393 4692 4693 4694 4695 4696 4699 4700 4703 4704 5573 5574 5577 5578 5581 5582 5585 5586 5589 5590 5617 5618 5619 5626 5627 5630 5631 5651 5652 5690 5691 5692 5695 5696 5699 5700 5703 5704 5707 5708
3025 3026
1193 1194 1209 1210 1213 1214 5690 5691 5692 5695 5696 5703 5704
7497 7498 7501 7502 7503 7608 7609 7641 7642 7645 7646 8200 8201 8202 8232 8233 8236 8237 8238
3234 3235 3236
5666 5667 5674 5675
7501 7502 7503 7516 7517 7518 8200 8201 8202
7501 7502 7503 8200 8201 8202 8371 8372 8375 8376 8377 8378 8379 8382 8383 8384 8386 8387 8390 8391 8401 8402 8403 8405 8408 8409 8448 8449
4836 4837 4840 4841 4844 4845 4848 4849 4852 4853 4855 4856 4857 4858
994 995
7501 7502 7503 8200 8201 8202 8371 8372 8375 8376 8377 8378 8379 8436 8437 8444 8445
1927 1928 1929 1940 1941 1942 1943 5558 5559 5690 5691 5692 5695 5696 5703 5704
540 541 542 549 550 553 554 555 556
2077 2078
2939 2940 3128 3129 3130 3148 3150 3151 3152 3171 3172
1316 1317 1580 1581
275 276 279 280 5573 5574 5593 5594 5595 5597 5599
407 408 4732 4733 4736 4737 4752 4753 4756 4757 5690 5691 5692 5695 5696 5703 5704
956 957 959
1193 1194 3286 3287 5690 5691 5692 5695 5696 5703 5704
1927 1928 1929 4866 4867 4870 4871 5690 5691 5692 5695 5696 5703 5704
949 950 951
7497 7498 7501 7502 7503 7516 7517 7518 8200 8201 8202 8371 8372 8375 8376 8377 8378 8379 8440 8441 8444 8445
7497 7498 7501 7502 7503 7676 7677 7678 7680 8200 8201 8202 8241 8242 8245 8246 8247
2855 2856 2857 2858 2873 2874 2875 2876 2877 2878 2879 2880 2881
3244 3245 3252 3253 3254 3255 5651 5652 5666 5667 5690 5691 5692

