0 1 2 3 4 5 6 7 8 9 10 11 12 13 14 15 16 17 171
18 19 20 21 22
23
24
12 17 25 26
22 27 28
16 22 29 30 31 32 33 34 35 36 37 38 39 40 41 42 43 44 45 46 47 48 49 50 51 52 53 54 55 56 57
58 59 60 61 62
63 64
0 1 16 26 45 65 66 67 68 69 70 71 72 73 74 75 76 77 78 79 80 81 82 83
84 85
24
3 12 13 17 86
72
59 60 61 62
64 87
18 19 20 21 22 88 89 90
64 87
91
92 93
26 94
95
64 87
63 64
96
97 98
99
100 101 102 103
64 87
104
63 64
22 27 28 105
96
106
107
24
23
108 109 110
111
112
113 114
21 90 115 116 117 118 119 120 121 122
72
0 1 16 18 19 20 21 22 53 54 56 72 90 91 122 123 124 125 126 127 128 129 130 131 132 133 134 135 136 137 138 139 140 141 142 143 144 145 146 147 148 149 150 151 152 153 154 155 156 157 158
159
26 160 161
63 64
24
0 1 16 45 65 66 69 70 71 75 76 77 80 82 83 96 162 163 164 165 166 167
22
108 168
24
24
64 87
24
63 64 169 170
24
26 172 173 174 175
96
96
63 64
63 64
0 1 16 22 26 32 34 35 36 37 38 39 40 41 42 43 44 45 46 47 48 49 50 51 52 53 54 55 56 57 66 67 68 69 70 71 72 73 74 75 76 77 78 79 80 81 83 123 176 177 178 179 180 181 182 183 184 185 186 187 188 189 190 191 192 193 194 195 196 197 198 199 200 201 202 203 204
205
63 64
0 1 16 18 21 22 31 53 54 56 72 90 122 124 125 126 127 130 131 132 137 138 139 140 143 145 146 149 150 151 152 153 154 156 206 207 208 209 210
113 211 212
24
0 1 16 22 29 36 37 45 50 51 56 65 66 69 70 71 75 76 77 80 82 83 96 162 163 164 165 166 167 177 179 182 183 184 185 188 192 194 197 199 200 201 202 203 213 214 215 216 217 218 219 220
221
63 64
90 172 173 174 175 222 223 224 225
64 87
63 64
226 227
22 27 28 105
0 1 16 45 65 66 69 70 71 75 76 77 80 82 83 96 162 163 164 165 166 167
24
228
3 5 6 7 10 11 14 15 22 90 172 173 174 175 222 223 224 225 229 230 231 232 233 234 235 236
21 23 237 238 239 240
24
241
53 54 108 109 242 243 244

93 245
72 246 247 248 249 250 251
24
226 252 253
64 87
