238 239 240 241 242 245 246 247 248 249 250 251 252 253 254 256 257 292 293 294 295 305 306 307 316 317 327 328 329 330 334 385 387 388 389 390 391 392 393 394 395 396 397 398 399 400 401 402 403 404 405 406 407 410 412 413 414 419 420 421 422 423 424 425 426 427 428 429 430 432 433 434 435 436 450 451 452 453 454 455 456 457 458 459 460 461 462 463 508 509 510 511 512 517 518 519 520 521 522 523 524 526 530 533 534 537 797 798 800 803 804
67 68 69 71 72 73 74 75 76 77 78 79 80 81 82 83 84 85 86 87 88 89 90 99 100 101 102 271 272 273 274 275 276 277 279 292 293 294 295 296 297 298 299 305 306 307 308 309 310 311 312 313 314 315 318 319 320 326 334 335 336 337 338 339 340 343 344 345 384 386 387 388 389 390 391 392 393 394 395 396 397 398 399 431 438 439 440 441 442 443 444 449 516 602 603 604 695 696 697 698 699 700 701 702 703 704 705 706 707 708 709 710 711 712 713 714 715 716 717 718 719 720 721 722 723 724 725 726 727 728 729 730 751 752 753 754 755 756 757 758 761 762 763 764 765 766 767 768 796 797 798 800 803 804
797 798 799 801 812 828
292 293 294 295 296 305 306 307 316 317 327 328 329 331 332 333 334 335 336 337 338 339 346 347 348 352 353 354 355 356 357 358 758 761 762 763 764 765 766 767 768 797 798 800 803 804
238 239 240 241 242 292 293 294 295 300 301 302 303 304 305 306 307 316 317 318 319 320 321 322 323 324 325 326 341 387 388 389 390 391 392 393 394 395 396 397 398 399 406 407 438 439 440 441 442 453 454 455 456 457 458 459 460 461 462 463 494 495 759 760 797 798 800 803 804
797 798 800 801 802 808 809 810 811 812 819 820
570 571 572 573 574 575 576 584 585 586 587 588 797 798 800 803 804
238 239 240 241 242 292 293 294 295 296 305 306 307 316 317 327 328 329 331 332 333 334 335 336 337 338 339 387 388 389 390 391 392 393 394 395 396 397 398 399 406 407 417 418 436 453 454 455 456 457 458 459 460 461 462 463 499 500 501 502 503 758 761 762 763 764 765 766 767 768 797 798 800 803 804
605 606 607 608 609 610 611 612 613 614 615 616 617 618 619 620 621 622 623 624 628 629 630 631 632 633 634 635 636 758 761 762 763 764 765 766 767 768 797 798 800 801 802 803 804
59 60 63 64 123 124 125 126 128 139 140 141 142 143 144 271 272 273 274 275 276 277 279 281 305 306 307 387 388 389 390 391 392 393 394 395 396 397 398 399 448 449 695 696 697 698 699 700 797 798 800 803 804
151 152 153 157 158 159 163 797 798 799 801
292 293 294 295 296 305 306 307 316 317 327 328 329 331 332 333 334 335 336 337 338 339 346 347 348 359 360 361 362 363 364 365 758 761 762 763 764 765 766 767 768 797 798 800 803 804
568 569 570 571 572 573 574 575 576 583 584 593 594 595 596 797 798 800 803 804
61 62 65 66 615 622 623 625 626 628 629 630 641 797 798 799 800 801 802
196 197 198 199 200 201 202 203 204 205 207 208 209 210 211 212 213 214 570 571 572 573 574 575 576 581 582 759 760 797 798 800 801 802 803 804
668 669 670 671 672 675 676 677 678 679 680 681 683 684 685 686 687 688 692 693 694
0 1 2 3 4 5 6 7 8 9 10 11 12 13 14 18 19 20 21 22 23 27 28 29 30 31 32 33 34 35 36 37 38 39 40 41 258 259 260 261 262 263 264 265 266 267 270 564 565 566 567 797 798 800 801 802 803 804
271 272 273 274 276 278 282 283 284 291 305 306 307 387 388 389 390 391 392 393 394 395 396 397 398 399
61 62 165 166 167 168 171 172 173 174 194 195 797 798 800 801 802
761 769 794 795 797 798 799 803
165 166 172 173 174 192 193 797 798 799 801
238 239 240 241 242 245 246 247 248 249 250 251 252 253 254 256 257 292 293 294 295 296 305 306 307 316 317 327 328 329 330 334 335 336 337 338 339 385 387 388 389 390 391 392 393 394 395 396 397 398 399 400 401 402 403 404 405 406 407 410 412 419 420 421 422 423 424 425 426 427 428 429 432 433 434 435 436 450 451 452 453 454 455 456 457 458 459 460 461 462 463 475 476 477 517 518 519 520 521 522 523 524 526 530 533 534 537 758 761 762 763 764 765 766 767 768 797 798 800 803 804
67 68 72 82 83 84 85 86 87 88 89 90 121 122 271 272 273 274 275 276 277 305 306 307 387 388 389 390 391 392 393 394 395 396 397 398 399 695 696 697 698 699 700 701 702 703 704 705 706 707 708 709 710 711 712 713 714 715 716 717 718 719 720 721 722 723 724 725 726 727 728 729 730 797 798 799 803
67 68 69 71 72 73 74 75 76 77 78 79 80 81 82 83 84 85 86 87 88 89 90 91 92 93 94 271 272 273 274 275 276 277 279 292 293 294 295 296 297 298 299 305 306 307 308 309 310 311 312 313 314 315 318 319 320 326 334 335 336 337 338 339 340 343 344 345 387 388 389 390 391 392 393 394 395 396 397 398 399 431 438 439 440 441 442 443 445 446 449 695 696 697 698 699 700 701 702 703 704 705 706 707 708 709 710 711 712 713 714 715 716 717 718 719 720 721 722 723 724 725 726 727 728 729 730 758 761 762 763 764 765 766 767 768 797 798 800 803 804
797 798 799 800 801 802 808 809 811 812 824
797 798 800 801 802 808 809 810 811 812 817 818
165 166 167 168 169 170 172 173 174 185 186 187 188 189 570 571 572 573 574 575 576 581 582 759 760 797 798 800 801 802 803 804
305 306 307 327 328 329 330 334 346 347 348 349 350 351 797 798 800 803 804
198 199 207 208 209 232 233 797 798 799 801
758 761 762 763 764 765 766 767 768 769 783 784 785 786 787 797 798 800 803 804
238 239 240 241 242 245 246 247 248 249 250 251 252 253 254 256 257 292 293 294 295 296 305 306 307 316 317 327 328 329 330 334 335 336 337 338 339 385 387 388 389 390 391 392 393 394 395 396 397 398 399 400 401 403 404 405 406 407 408 409 410 411 412 419 420 421 422 423 424 425 426 427 428 429 432 433 434 435 436 450 451 452 453 454 455 456 457 458 459 460 461 462 463 486 487 488 489 517 518 519 520 521 522 523 524 526 530 533 534 537 758 761 762 763 764 765 766 767 768 797 798 800 803 804
797 798 799 801 808 812 829
758 761 762 763 764 765 766 767 768 769 788 789 790 791 797 798 800 803 804
0 1 2 3 4 5 6 7 8 9 10 11 12 13 14 18 19 20 21 22 23 30 31 32 33 34 35 36 53 54 55 56 57 58 258 259 260 261 262 263 264 265 266 267 268 270 797 798 800 801 802 803 804
797 798 800 801 802 808 809 810 811 812 821 822
797 798 800 803 804 831 832 833 834 835 836 837 838 839 840 841 842 843 844 845 846
238 239 240 241 242 243 244 245 246 248 249 254 255 517 518 519 520 521 522 523 524 525 526 529 530 531 532 533 534 535 536 537 542 543 544 545 546 547 548 553 554 555 797 798 800 803 804 831 832 833 834 835 836 837 838 839 840
731 732 738 739 740 741
292 293 294 295 296 297 298 299 305 306 307 308 309 310 316 317 334 335 336 337 338 339 343 344 345 346 347 348 376 377 378 379 380 381 758 761 762 763 764 765 766 767 768 797 798 800 803 804
568 569 570 571 572 573 574 575 576 577 578 579 580 584 597 598 599 600 601 797 798 800 803 804
731 732 733 734 735 736 737 738 744 745 746 747 748 749 750
238 239 240 241 242 292 293 294 295 305 306 307 316 317 318 319 320 321 322 323 324 325 326 342 387 388 389 390 391 392 393 394 395 396 397 398 399 406 407 417 418 438 439 440 441 442 453 454 455 456 457 458 459 460 461 462 463 470 471 472 473 474 759 760 797 798 800 803 804
797 798 799 803 831 841 847 848
797 798 799 800 801 802 808 809 811 812 823
151 152 153 154 155 156 157 158 159 160 161 162 570 571 572 573 574 575 576 582 797 798 800 801 802 803 804
731 738 742 743
759 769 792 793 797 798 799 803
67 68 69 71 72 73 74 75 76 77 78 79 80 81 82 83 84 85 86 87 88 89 90 103 104 105 106 271 272 273 274 275 276 277 279 292 293 294 295 296 297 298 299 305 306 307 308 309 310 311 312 313 314 315 318 319 320 326 334 335 336 337 338 339 340 343 344 345 387 388 389 390 391 392 393 394 395 396 397 398 399 431 438 439 440 441 442 443 444 449 695 696 697 698 699 700 701 702 703 704 705 706 707 708 709 710 711 712 713 714 715 716 717 718 719 720 721 722 723 724 725 726 727 728 729 730 758 761 762 763 764 765 766 767 768 797 798 800 803 804
67 68 69 71 72 73 74 75 76 77 78 79 80 81 82 83 84 85 86 87 88 89 90 111 112 113 114 271 272 273 274 275 276 277 279 292 293 294 295 296 297 298 299 305 306 307 308 309 310 311 312 313 314 315 318 319 320 326 334 335 336 337 338 339 340 343 344 345 387 388 389 390 391 392 393 394 395 396 397 398 399 431 438 439 440 441 442 443 445 447 449 695 696 697 698 699 700 701 702 703 704 705 706 707 708 709 710 711 712 713 714 715 716 717 718 719 720 721 722 723 724 725 726 727 728 729 730 758 761 762 763 764 765 766 767 768 797 798 800 803 804
271 272 273 274 275 276 277 279 282 283 284 285 286 287 288 289 290 305 306 307 387 388 389 390 391 392 393 394 395 396 397 398 399
165 166 167 168 169 170 172 173 174 180 181 182 183 184 570 571 572 573 574 575 576 581 582 759 760 797 798 800 801 802 803 804
61 62 198 199 200 201 203 204 205 206 207 208 209 234 235 759 760 797 798 800 801 802 803 804
292 293 294 295 297 298 299 305 306 307 308 309 310 316 317 343 344 345 346 347 348 366 367 368 369
238 239 240 241 242 245 246 247 248 249 250 251 252 253 254 256 257 292 293 294 295 305 306 307 316 317 327 328 329 330 334 385 387 388 389 390 391 392 393 394 395 396 397 398 399 400 401 402 403 404 405 406 407 410 412 415 416 419 420 421 422 423 424 425 426 427 428 429 432 436 450 451 452 453 454 455 456 457 458 459 460 461 462 463 478 479 480 481 517 518 519 520 521 522 523 524 526 530 533 534 537 797 798 800 803 804
67 68 69 71 72 73 74 75 76 77 78 79 80 81 82 83 84 85 86 87 88 89 90 107 108 109 110 271 272 273 274 275 276 277 279 292 293 294 295 296 297 298 299 305 306 307 308 309 310 311 312 313 314 315 318 319 320 326 334 335 336 337 338 339 340 343 344 345 387 388 389 390 391 392 393 394 395 396 397 398 399 431 438 439 440 441 442 443 445 447 449 695 696 697 698 699 700 701 702 703 704 705 706 707 708 709 710 711 712 713 714 715 716 717 718 719 720 721 722 723 724 725 726 727 728 729 730 758 761 762 763 764 765 766 767 768 797 798 800 803 804
238 239 240 241 242 243 244 245 246 248 249 254 255 517 518 519 520 521 522 523 524 525 526 529 530 531 532 533 534 535 536 537 542 543 544 545 546 547 548 556 557 558 559 560 797 798 800 803 804 831 832 833 834 835 836 837 838 839 840
305 306 307 327 346 347 348 382 383 797 798 799 803
758 761 762 763 764 765 766 767 768 769 774 775 776 777 797 798 800 803 804
59 60 63 64 67 68 69 70 72 82 83 84 85 86 87 88 89 90 119 120 271 272 273 274 275 276 277 279 281 305 306 307 387 388 389 390 391 392 393 394 395 396 397 398 399 448 449 695 696 697 698 699 700 701 702 703 704 705 706 707 708 709 710 711 712 713 714 715 716 717 718 719 720 721 722 723 724 725 726 727 728 729 730 797 798 800 803 804
797 798 799 801 812 830
797 798 800 801 802 805 806 807 812 815 816
61 62 65 66 615 622 625 626 628 629 630 643 797 798 799 801
165 166 167 168 169 170 172 173 174 175 176 177 178 179 570 571 572 573 574 575 576 581 582 759 760 797 798 800 801 802 803 804
123 124 128 139 140 141 142 145 146 271 272 273 274 275 276 277 305 306 307 387 388 389 390 391 392 393 394 395 396 397 398 399 695 696 697 698 699 700 797 798 799 803
644 645 646 652 653 654 655 656 657 658 665 666 667
570 571 572 573 574 575 576 577 578 579 580 584 589 590 591 592 797 798 800 803 804
0 1 2 3 4 5 6 7 8 9 10 11 12 13 14 15 16 17 18 19 20 21 22 23 30 31 32 33 34 35 36 47 48 49 50 51 258 259 260 261 262 263 264 265 266 267 268 797 798 800 801 802 803 804
758 759 760 761 762 763 764 765 766 767 768 769 778 779 780 781 782 797 798 800 803 804
797 798 799 803 812 827
198 199 200 201 202 203 204 205 207 208 209 225 226 227 228 229 570 571 572 573 574 575 576 581 582 759 760 797 798 800 801 802 803 804
198 199 200 201 202 203 204 205 207 208 209 220 221 222 223 224 570 571 572 573 574 575 576 581 582 759 760 797 798 800 801 802 803 804
123 124 125 127 128 129 130 131 132 133 134 135 136 137 138 139 140 141 142 147 148 149 150 271 272 273 274 275 276 277 279 280 305 306 307 387 388 389 390 391 392 393 394 395 396 397 398 399 695 696 697 698 699 700 758 761 762 763 764 765 766 767 768 797 798 800 803 804
0 1 2 3 4 5 6 7 8 9 10 11 12 13 14 18 19 20 21 22 23 24 25 26 30 31 32 33 34 35 36 42 43 44 45 46 258 259 260 261 262 263 264 265 266 267 269 797 798 800 801 802 803 804
165 166 172 173 174 190 191 797 798 799 801
61 62 65 66 615 622 623 625 626 628 629 630 640 797 798 799 800 801 802
797 798 799 800 801 802 808 809 811 812 826
292 293 294 295 296 297 298 299 305 306 307 308 309 310 316 317 334 335 336 337 338 339 343 344 345 346 347 348 370 371 372 373 374 375 758 761 762 763 764 765 766 767 768 797 798 800 803 804
67 68 69 71 72 73 74 75 76 77 78 79 80 81 82 83 84 85 86 87 88 89 90 95 96 97 98 271 272 273 274 275 276 277 279 292 293 294 295 296 297 298 299 305 306 307 308 309 310 311 312 313 314 315 318 319 320 326 334 335 336 337 338 339 340 343 344 345 387 388 389 390 391 392 393 394 395 396 397 398 399 431 438 439 440 441 442 443 445 446 449 695 696 697 698 699 700 701 702 703 704 705 706 707 708 709 710 711 712 713 714 715 716 717 718 719 720 721 722 723 724 725 726 727 728 729 730 758 761 762 763 764 765 766 767 768 797 798 800 803 804
198 199 207 208 209 230 231 797 798 799 801
238 239 240 241 242 245 246 248 249 254 292 293 294 295 305 306 307 316 317 327 328 329 330 334 385 387 388 389 390 391 392 393 394 395 396 397 398 399 406 407 410 412 419 420 421 422 423 424 425 426 428 429 436 450 451 452 453 454 455 456 457 458 459 460 461 462 463 513 514 515 517 518 519 520 521 522 523 524 526 530 533 534 537 797 798 800 803 804
61 62 65 66 615 622 625 626 628 629 630 642 797 798 799 801
238 239 240 241 242 243 244 245 246 248 249 254 517 518 519 520 521 522 523 524 526 527 528 530 533 534 535 536 537 542 543 544 545 546 547 548 561 562 563
238 239 240 241 242 243 244 245 246 248 249 254 517 518 519 520 521 522 523 524 525 526 529 530 531 532 533 534 535 536 537 538 539 540 541 542 543 544 545 546 547 548 549 550 551 552 797 798 800 803 804 831 832 833 834 835 836 837 838 839 840
61 62 198 199 200 203 204 206 207 208 209 236 237 797 798 800 801 802
238 239 240 241 242 292 293 294 295 300 301 302 303 304 305 306 307 316 317 318 319 320 321 322 323 324 325 326 341 342 387 388 389 390 391 392 393 394 395 396 397 398 399 406 407 438 439 440 441 442 453 454 455 456 457 458 459 460 461 462 463 490 491 492 493 759 760 797 798 800 803 804
0 1 2 3 4 5 6 7 8 9 10 15 18 19 20 21 22 23 30 33 34 35 36 52 797 798 799 800 801 802 803 804
797 798 799 801 812 825
151 152 153 157 158 159 164 797 798 799 801
609 610 612 644 645 646 647 648 649 650 651 653 654 655 656 657 658 659 660 661 662 663 664
615 627 628 629 630 637 638 639
238 239 240 241 242 245 246 247 248 249 254 256 257 292 293 294 295 305 306 307 316 317 327 328 329 330 334 385 387 388 389 390 391 392 393 394 395 396 397 398 399 406 407 408 409 410 411 412 419 420 421 422 423 424 425 426 428 429 436 437 450 451 452 453 454 455 456 457 458 459 460 461 462 463 464 465 466 467 468 469 517 518 519 520 521 522 523 524 526 530 533 534 537 797 798 800 803 804
67 68 69 71 72 73 74 75 76 77 78 79 80 81 82 83 84 85 86 87 88 89 90 115 116 117 118 271 272 273 274 275 276 277 279 292 293 294 295 296 297 298 299 305 306 307 308 309 310 311 312 313 314 315 316 317 318 319 320 326 334 335 336 337 338 339 340 343 344 345 387 388 389 390 391 392 393 394 395 396 397 398 399 406 407 431 438 439 440 441 442 443 445 447 449 695 696 697 698 699 700 701 702 703 704 705 706 707 708 709 710 711 712 713 714 715 716 717 718 719 720 721 722 723 724 725 726 727 728 729 730 758 761 762 763 764 765 766 767 768 797 798 800 803 804
198 199 200 201 202 203 204 205 207 208 209 215 216 217 218 219 570 571 572 573 574 575 576 581 582 759 760 797 798 800 801 802 803 804
238 239 240 241 242 245 246 247 248 249 250 251 252 253 254 256 257 292 293 294 295 305 306 307 316 317 327 328 329 330 334 385 387 388 389 390 391 392 393 394 395 396 397 398 399 400 401 402 403 404 405 406 407 410 412 413 414 419 420 421 422 423 424 425 426 427 428 429 432 433 434 435 436 450 451 452 453 454 455 456 457 458 459 460 461 462 463 482 483 484 485 517 518 519 520 521 522 523 524 526 530 533 534 537 797 798 800 803 804
759 760 769 770 771 772 773 797 798 800 803 804
238 239 240 241 242 245 246 247 248 249 254 292 293 294 295 305 306 307 316 317 327 328 329 330 334 385 387 388 389 390 391 392 393 394 395 396 397 398 399 406 407 410 412 419 420 421 422 423 424 425 426 428 429 436 450 451 452 453 454 455 456 457 458 459 460 461 462 463 496 497 498 517 518 519 520 521 522 523 524 526 530 533 534 537 797 798 800 803 804
668 669 670 671 672 673 674 676 677 678 679 680 681 682 683 684 685 686 687 688 689 690 691
238 239 240 241 242 245 246 247 248 249 250 251 252 253 254 256 257 292 293 294 295 296 305 306 307 316 317 327 328 329 330 334 335 336 337 338 339 385 387 388 389 390 391 392 393 394 395 396 397 398 399 400 401 402 403 404 405 406 407 410 412 419 420 421 422 423 424 425 426 427 428 429 430 432 433 434 435 436 450 451 452 453 454 455 456 457 458 459 460 461 462 463 504 505 506 507 517 518 519 520 521 522 523 524 526 530 533 534 537 758 761 762 763 764 765 766 767 768 797 798 800 803 804
797 798 800 801 802 808 809 810 811 812 813 814
