16 25 26 27 53 70 71 72 73 74 260 318 953 954 955 956 957 958 959 961 962 963 964 965 967 968 970 971 972 973 995 996 997 998 999
474 475 476 477 478 479 486 489 490 491 492 493 494 495 496 497 498 499 500 519 520 521 522 523 524
1043 1044 1045 1046 1047 1050 1052 1053 1054 1055 1057 1058 1059 1063
144 145 313 314 315 316 317 533 534 569 570 571 572 573 574 575 576 577 578 580 581 582 583 584 585 586 587 588 589 590 591 599 600 601 602 603 604 605 606 607
247 354 654 655 656 657 658 659 660 671 695 697 698 699 700 701 702 703 704 729 730 731
321 322 324 325 326 327 328 329 330 333 334 335 336 337 343 344 345 346 347
313 314 315 316 317 355 356 357 358 359 360 361 362 363 364 365 366 367 368 369 372 373 374 375 381 382 383 384 385 386 387 403 404 405 406 407 408
247 321 654 655 656 657 658 659 660 691 773 774 775 776 777 778 779 780 781 782 783 784 785 786
144 145 355 356 365 366 369 435 436 437 438 439 440 441 442 443 444 446 447 448 449 450 451 452 453 454 455 456 457 466 467 468 469 470 471 472 473 533 544 545 546 547 548 549 552 569 570 571 576 577 581
272 273 274 275 276 277 278 279 280 281 286 287 288 289 290
313 314 315 316 317 355 356 357 358 359 360 361 362 363 364 365 366 367 368 369 372 373 374 375 381 382 383 384 385 386 387 388 389 390 391 392
247 654 655 656 657 658 659 660 661 676 677 678 679 680 681 682 683 684 686 692 695 697 698 699 700 701 702 703 704 753 754 755 756 757 758
533 534 535 536 537 538 539 540 541 542 543
474 475 476 477 478 479 480 481 482 483 484 489 490 491 492 493 494 495 496 501 502 503 504 505 506 507 508 509 510 511 512 513 514 515 516
16 25 26 27 70 71 72 73 74 75 78 79 80 82 83 84 85 86 87 88 89 90 91 92 93 94 95 96 97 98 99 100 101 116 117 127 128 129 130 131 132 260 318
355 356 533 544 545 546 547 548 549 550 551 552 553 554 555 556 557 558 559 560 561 562 563 564 565 646 647 648 649 650 651 652 653
16 25 26 27 53 70 71 72 73 74 260 318 953 954 955 956 957 958 959 961 962 963 964 965 967 968 969 970 971 972 973 979 980 981 982 983 984
625 626 627 628 629 630 631 632 633 642 643 644 645
152 153 154 155 156 157 158 159 160 181 182 183 186 187 188 189 190 191 192 193 195 196 197 198 214 215 216 217 218 219 220 230 231 232 237 238 239 240
272 318 787 788 789 790 811 812 850 851 852 853 854 855 856 857 858 859 860 861 862 863 864 865 869 870 871 872 873 874 884 885 886 887 888 889
16 25 26 27 53 70 71 72 73 74 260 318 953 954 955 956 957 958 959 960 961 962 963 964 965 967 968 970 971 972 973 1003 1004 1005
144 145 313 314 315 316 317 533 534 569 570 571 572 573 574 575 576 577 578 580 581 582 583 584 585 586 587 588 589 590 591 608 609 610 611 612 613 614 615
355 356 533 544 545 546 547 548 552 555 556 557 564 565 566 567 568 646 647 648 649 650 651
16 25 26 27 70 71 72 73 74 75 78 79 80 82 83 84 85 86 87 88 89 90 91 92 93 94 95 96 97 98 99 100 101 116 117 133 134 135 136 137 138 260 318
149 150 151 181 182 183 184 185 192 194 202 203 204 205 207 211 212 214 215 216 217 218 219 220 227 228 229 237 238 239 240
260 261 262 263 264 265 266 267
16 25 26 27 70 71 72 73 74 75 76 77 78 79 80 82 83 84 85 86 87 88 89 90 91 92 93 94 95 96 97 98 99 100 101 116 117 118 119 120 121 122 123 124 125 126 260 318
16 25 26 27 70 71 72 73 74 75 78 79 80 82 83 84 85 86 87 88 89 90 91 92 93 94 95 96 97 98 99 100 101 105 106 107 116 117 260 318
53 54 55 56 57 58 59 60 61 62 63
16 25 26 27 53 70 71 72 73 74 260 318 953 954 955 956 957 958 959 961 962 963 964 965 966 968 969 970 971 972 973 990 991 992 993 994
1043 1044 1045 1046 1047 1056 1057 1058 1059 1065
144 145 313 314 315 316 317 533 534 569 570 571 572 573 574 575 576 577 578 580 581 582 583 584 585 586 587 588 589 590 591 592 593 594 595 596 597 598
16 25 26 27 53 70 71 72 73 74 260 318 953 954 955 956 957 958 959 961 962 963 964 965 967 968 969 970 971 972 973 985 986 987 988 989
272 275 276 277 318 319 320 787 788 789 790 791 792 793 794 795 796 797 798 799 800 801 802 803 804 805 806 807 808 809 810 811 812 813 814 819 820 821 822 823 824 825 826 827 828 829 830 831 832 833 834 835 836 837 838 839 840 841 842 843 844 845 846 847 848 849 890 893 894 895 901 902 903 904 905 906 907 918 919 920 921 922 923 924 925 926 927 952
272 318 787 788 789 790 811 812 850 851 852 853 854 855 856 857 858 859 860 861 862 863 864 865 869 870 871 872 873 874 878 879 880 881
3 4 5 12 272 275 276 277 318 319 320 787 788 789 790 791 792 793 794 795 796 797 798 799 800 801 802 803 804 805 806 807 808 809 810 811 812 813 814 819 820 821 822 823 824 825 826 827 828 829 830 831 832 833 834 835 836 837 838 839 840 841 842 843 844 845 846 847 848 849 893 894 895 908 909 910 911 912 918 919 920 921 922 923 952
474 475 476 477 478 479 485 494 495 496 517 518
16 25 26 27 53 70 71 72 73 74 260 318 953 954 955 956 957 958 959 961 962 963 964 965 967 968 969 970 971 972 973 974 975 976 977 978
260 261 264 265 270 271
313 314 315 316 317 355 356 357 358 359 360 361 362 363 364 365 366 367 368 369 372 373 374 375 381 382 383 384 409 410 411 412 413
3 4 5 12 272 275 276 277 318 319 320 787 788 789 790 791 792 793 794 795 796 797 798 799 800 801 802 803 804 805 806 807 808 809 810 811 812 813 814 819 820 821 822 823 824 825 826 827 828 829 830 831 832 833 834 835 836 837 838 839 840 841 842 843 844 845 846 847 848 849 893 894 895 913 914 915 916 917 918 919 920 921 922 923 952
1043 1044 1045 1046 1047 1051 1052 1053 1054 1055 1057 1058 1059 1064
16 25 26 27 70 71 72 73 74 75 78 79 80 82 83 84 85 86 87 88 89 90 91 92 93 94 95 96 97 98 99 100 101 108 109 110 116 117 260 318
247 646 647 648 649 650 653 654 655 656 657 658 659 660 661 662 663 664 669 670 676 677 688 692 693 694 695 696 697 698 699 700 701 702 703 704 726 727 728
291 292 293 294 297 298 309 310 311 312 625 628
16 25 26 27 70 71 72 73 74 75 78 79 80 82 83 84 85 86 87 88 89 90 91 92 93 94 95 96 97 98 99 100 101 111 112 113 114 115 116 117 260 318
1043 1044 1045 1046 1047 1048 1049 1057 1058 1059 1060 1061 1062
146 147 148 181 182 183 184 185 192 194 195 196 197 198 202 203 204 205 207 208 209 210 211 213 214 215 216 217 218 219 220 221 222 223 235 236 237 238 239 240
146 147 148 181 182 183 184 185 192 194 195 196 197 198 199 200 201 202 203 204 205 206 211 213 214 215 216 217 218 219 220 221 222 223 237 238 239 240 241 242 243 244 245 246 766 767 768 769 770 771 772
474 475 476 477 478 479 487 494 495 496 525 526
152 153 154 155 156 157 158 159 160 181 182 183 186 187 188 189 190 191 192 193 195 196 197 198 214 215 216 217 218 219 220 233 234 237 238 239 240
321 322 324 325 326 327 328 329 330 333 334 335 336 337 348 349 350 351 352
247 646 647 648 649 650 654 655 656 657 658 659 660 661 662 663 664 669 670 674 676 677 678 679 680 681 682 685 686 687 688 692 693 694 695 696 697 698 699 700 701 702 703 704 744 745 746 747 748 749 750 751 752
272 275 276 277 318 319 320 787 788 789 790 791 792 793 794 795 796 797 798 799 800 801 802 803 804 805 806 807 808 809 810 811 812 813 814 819 820 821 822 823 824 825 826 827 828 829 830 831 832 833 834 835 836 837 838 839 840 841 842 843 844 845 846 847 848 849 890 893 894 895 901 902 903 904 905 906 907 918 919 920 921 922 923 932 933 934 935 936 952
260 261 264 265 268 269
152 153 154 155 156 157 158 159 160 161 162 163 164 165 166 167 168 175 176 177
625 626 627 628 629 630 631 632 633 638 639 640 641
16 17 18 19 20 21 22 23 25 26 27 28 29 30 31 32 33 34 35 36 37 38 39 40 41 42 43 47 48 49 50 51 52 318 319 320
152 153 154 155 156 157 158 159 160 161 162 163 164 175 176 177 178 179 180
313 314 315 316 317 355 356 357 358 359 360 361 362 363 364 365 366 367 368 369 372 373 374 375 419 420 421
321 322 323 324 325 326 327 328 329 330 331 332 333 334 335 336 337 338 339 340 341 342 353
53 54 55 56 57 58 59 60 61 66 67
247 654 655 656 657 658 659 660 689 695 697 698 699 700 701 702 703 704 761 762 763
313 314 315 316 317 355 356 357 358 359 360 361 362 363 364 365 366 367 368 369 372 373 374 375 381 382 383 384 385 386 387 422 423 424 425 426 427 428 429 430
53 54 55 56 57 58 59 60 61 68 69
247 646 647 648 649 650 653 654 655 656 657 658 659 660 661 662 663 664 669 670 676 677 688 692 693 694 695 696 697 698 699 700 701 702 703 704 720 721 722
625 626 627 628 629 630 631 632 633 634 635 636 637
247 646 647 648 649 650 654 655 656 657 658 659 660 661 662 663 664 667 668 676 677 688 692 693 694 695 697 698 699 700 701 702 703 704 705 706 707 708 709 710
291 292 293 294 295 296 297 298 299 300 301 302 625 628
16 24 25 26 27 70 71 72 73 74 75 78 79 80 82 83 84 85 86 87 88 89 90 91 92 93 94 95 96 97 98 99 100 101 102 103 104 116 117 260 318
313 314 315 316 317 355 356 357 358 359 360 361 362 363 364 365 366 367 368 369 372 373 374 375 381 382 383 384 398 399 400 401 402
247 654 655 656 657 658 659 660 672 695 697 698 699 700 701 702 703 704 732 733 734
247 654 655 656 657 658 659 660 690 695 697 698 699 700 701 702 703 704 764 765
247 646 647 648 649 650 654 655 656 657 658 659 660 661 662 663 664 665 666 676 677 688 692 693 694 695 697 698 699 700 701 702 703 704 711 712 713 714 715 716
144 145 313 314 315 316 317 533 569 570 571 572 573 575 576 577 578 579 580 581 582 583 584 585 586 587 588 589 590 591 616 617 618 619 620 621
272 275 276 277 318 319 320 787 788 789 790 791 792 793 794 795 796 797 798 799 800 801 802 803 804 805 806 807 808 809 810 811 812 813 814 819 820 821 822 823 824 825 826 827 828 829 830 831 832 833 834 835 836 837 838 839 840 841 842 843 844 845 846 847 848 849 893 894 895 918 919 920 921 922 923 928 929 930 931 952
152 153 154 155 156 157 158 159 160 161 162 163 164 172 173 174 175 176 177
247 248 249 250 251 252 253 254 255 256 257 258 259
272 273 274 275 276 277 278 279 280 281 282 283 284 285
16 25 26 27 53 70 71 72 73 74 260 318 953 954 955 956 957 958 959 961 962 963 964 965 967 968 970 971 972 973 1000 1001 1002
145 365 366 369 437 438 439 440 441 442 443 444 445 447 448 449 450 451 452 453 454 455 456 457 458 459 460 461 462 463 464 465 547 548 549 552 576 577 581
152 153 154 155 156 157 158 159 160 161 162 163 164 169 170 171
247 654 655 656 657 658 659 660 675 695 697 698 699 700 701 702 703 704 759 760
313 314 315 316 317 355 356 357 358 359 360 361 362 363 364 365 366 367 368 369 372 373 374 375 381 382 383 384 414 415 416 417 418
0 1 2 15 247 646 647 648 649 650 652 654 655 656 657 658 659 660 661 662 663 664 669 670 676 677 688 692 693 694 695 696 697 698 699 700 701 702 703 704 717 718 719
291 292 293 294 297 298 303 304 305 306 307 308 625 628 630 631
272 275 276 277 318 319 320 787 788 789 790 791 792 793 794 795 796 797 798 799 800 801 802 803 804 805 806 807 808 809 810 811 812 813 814 819 820 821 822 823 824 825 826 827 828 829 830 831 832 833 834 835 836 837 838 839 840 841 842 843 844 845 846 847 848 849 866 867 868 890 891 892 893 894 895 901 902 903 904 905 906 907 918 919 920 921 922 923 942 943 944 945 946 947 948 949 950 951 952
272 787 788 789 790 811 812 869 871 872 873 874 875 876 877 882 883
6 7 8 13 272 273 274 275 276 277 318 319 320 787 788 789 790 791 792 793 794 795 796 797 798 799 800 801 802 803 804 805 806 807 808 809 810 811 812 813 814 815 816 817 818 819 820 821 822 823 824 825 826 827 828 829 830 831 832 833 834 835 836 837 838 839 840 841 842 843 844 845 846 847 848 849 893 894 895 896 897 898 899 900 918 919 920 921 922 923 952
16 25 26 27 53 70 71 72 73 74 260 318 953 954 955 956 957 958 1006 1007 1008 1009 1010 1011 1012 1013 1014 1015 1016 1017 1018 1019 1020 1021 1022 1023 1024 1025 1026 1027 1028 1029 1030 1031 1032 1033 1034 1035 1036 1037 1038 1039 1040 1041 1042
247 646 647 648 649 650 654 655 656 657 658 659 660 661 662 663 664 669 670 673 676 677 678 679 680 681 682 685 686 687 688 692 693 694 695 696 697 698 699 700 701 702 703 704 735 736 737 738 739 740 741 742 743
0 1 2 15 247 646 647 648 649 650 652 654 655 656 657 658 659 660 661 662 663 664 669 670 676 677 688 692 693 694 695 696 697 698 699 700 701 702 703 704 723 724 725
16 25 26 27 70 71 72 73 74 78 79 80 81 83 84 85 86 87 88 89 90 91 92 93 94 95 96 97 98 99 100 101 116 117 139 140 141 142 143 260 318
313 314 315 316 317 355 356 357 358 359 360 361 362 363 364 365 366 367 368 369 370 371 372 373 374 375 381 382 383 384 385 386 387 393 394 395 396 397
9 10 11 14 272 275 276 277 318 319 320 787 788 789 790 791 792 793 794 795 796 797 798 799 800 801 802 803 804 805 806 807 808 809 810 811 812 813 814 819 820 821 822 823 824 825 826 827 828 829 830 831 832 833 834 835 836 837 838 839 840 841 842 843 844 845 846 847 848 849 893 894 895 918 919 920 921 922 923 937 938 939 940 941 952
16 17 18 19 20 21 22 23 25 26 27 28 29 30 31 32 33 34 35 36 37 38 39 40 41 42 43 44 45 46 318 319 320
53 54 55 56 57 58 59 60 61 64 65
313 314 315 316 317 355 356 357 358 359 360 361 362 363 364 365 366 367 368 369 372 373 374 375 376 377 378 379 380 381 382 383 384 385 386 387
146 147 148 181 182 183 184 185 192 194 195 196 197 198 202 203 204 205 207 208 209 210 211 213 214 215 216 217 218 219 220 224 225 226 237 238 239 240
144 145 313 314 315 316 317 533 569 570 571 576 577 581 582 583 584 585 586 587 588 589 590 591 622 623 624
313 314 315 316 317 355 356 357 358 359 360 361 362 363 364 365 366 367 368 369 372 373 374 375 381 382 383 384 431 432 433 434
474 475 476 477 478 479 488 489 490 491 492 493 494 495 496 497 498 499 500 527 528 529 530 531 532
