2280 2281 2282 2284 2285 2286 2287 2290 2291 2333 2334 2337 2338 2349 2350 2351 2352
278 279 280 290 291 294
398 399 1626 1627 1634 1635 1751 1752 1759 1760 1767 1768 1775 1776 1791 1792 1793 1794 1797
473 474
342 343 350 351 358 359 366 367 374 375 382 383 390 391 398 399 415 416
1999 2000
1270 1271 1354 1355 1626 1627 1634 1635 2321 2322 2323 2324 2325
26 27 28 30 31 32 33 38 57 59 2639 2640 2643
407 408 411 412
278 279 282 309 311 312 313 314 315 316 1446 1447 1448 1449 1450 1451 1452 1453 1460 1461
797 798 813 814 829 830 831 863 864 866 867 950 951 952 954 957 958 959 976 977 992 994 995 996 997 999 1000 1001 1003 1004 1005 1010 1446 1447 1448 1449 1450 1451 1452 1453 1460 1461 2704 2706 2707 2708 2709 2710 2711
847 848 902 903 942 943 984 985 992 994 995 996 997 999 1010 1037 1038 1045 1046 1446 1447 1448 1449 1450 1451 1452 1453 1460 1461
658 659 666 667 674 675
278 279 282 290 291 292
2311 2312 2333 2334 2337 2338
2076 2077 2078 2079 2333 2334 2337 2338
1967 1968 1976 1977 1978 1979 2345 2346 2495 2496 2555 2556 2557 2558 2559 2560 2563 2579 2580 2665 2666
797 798 821 822 829 830 863 864 865 950 951 952 954 957 958 959 967 968 992 994 995 996 997 999 1000 1001 1002 1010 1446 1447 1448 1449 1450 1451 1452 1453 1460 1461 2704 2706 2707 2708 2709 2710 2711
1679 1680 1687 1688 1695 1696 1703 1704
457 458 461
57 59 2211 2212 2213 2216 2333 2334 2337 2338
1142 1143 1230 1231 1286 1287 1568 1569 1576 1577
1446 1447 1448 1449 1450 1451 1452 1453 1460 1461 1924 1925 1932 1934 1935 1936 1937 1938 1939
290 291 294 309 311 312 313 314 315 316 1446 1447 1448 1449 1450 1451 1452 1453 1460 1461
1294 1295 1302 1303
1446 1447 1448 1449 1450 1451 1452 1453 1460 1461 1679 1680 1687 1688 1711 1713 1714 1715 1716 1717
57 59 2045 2046 2049
2223 2224 2225 2226 2227
57 59 2087 2088 2091 2333 2334 2337 2338
732 733 741 742 750 751 759 760 769 770 1311 1312
839 840 855 856 902 903 910 911 918 919 926 927 934 935 1029 1030 1037 1038 1045 1046
57 59 2197 2198 2201 2202
553 554 561 562 569 570 619 620 627 628 635 636
1230 1231
57 59 2076 2077 2078 2079 2333 2334 2337 2338
57 59 2184 2185 2188 2189 2333 2334 2337 2338
435 436 439 440
1492 1493 1508 1509 1524 1525
26 27 28 30 31 32 33 38 57 59 2594 2595 2596 2597 2598 2601 2602 2603
1446 1447 1448 1449 1450 1451 1452 1453 1460 1461 1913 1914 1917 1932 1934 1935 1936 1937 1938 1939
2211 2212 2213 2216 2333 2334 2337 2338
301 302 309 311 312 313 314 315 316 1446 1447 1448 1449 1450 1451 1452 1453 1460 1461
2118 2119 2122 2123 2125 2126 2130 2143 2144 2145 2146 2147 2333 2334 2337 2338 2349 2350 2351 2352
2246 2247 2248 2249 2337 2338
813 814 821 822 829 830 831 950 951 952 953 954 957 958 959 967 968 976 977
561 562 569 570 593 595 596 597 598 599 1446 1447 1448 1449 1450 1451 1452 1453 1460 1461
2615 2616 2617 2619 2620 2621 2622 2623 2624 2625 2626 2627 2631 2632 2639 2640 2641
57 59 2156 2157 2160 2161 2333 2334 2337 2338
448 449
57 59 2246 2247 2248 2249 2337 2338
2024 2025
561 562 569 570 577 578 585 586
1262 1263
57 59 2033 2034 2037 2038
57 59 2170 2171 2174 2175 2333 2334 2337 2338
1446 1447 1448 1449 1450 1451 1452 1453 1460 1461 1568 1569 1576 1577 1600 1602 1603 1604 1605 1606
813 814 821 822 829 830 831 950 951 952 953 954 957 958 959 967 968 976 977
57 59 2118 2119 2122 2123 2125 2126 2130 2143 2144 2145 2146 2333 2334 2337 2338 2349 2350 2351 2352
2184 2185 2188 2189 2333 2334 2337 2338
136 137 144 145 152 153 160 161
508 509 512 513
1679 1680 1687 1688
466 467
2033 2034 2037 2038
57 59 2024 2025
658 659 666 667 674 675 682 683 690 691 698 699
2099 2100 2101 2103 2104 2105 2108 2109 2333 2334 2337 2338 2349 2350 2351 2352
1446 1447 1448 1449 1450 1451 1452 1453 1460 1461 1492 1493 1508 1509 1524 1525 1540 1542 1543 1544 1545 1546 1547
57 59 2280 2281 2282 2284 2285 2286 2287 2290 2291 2333 2334 2337 2338 2349 2350 2351 2352
57 59 2057 2058 2059 2061 2062 2063 2064 2067 2068 2349 2350 2351 2352
2256 2257 2258 2259 2337 2338
424 425 428
2045 2046 2049
2118 2119 2120 2122 2123 2125 2126 2127 2128 2130 2133 2134 2333 2334 2337 2338 2349 2350 2351 2352
1901 1902 1903 1913 1914 1917
57 59 2235 2236 2237 2238 2239
2300 2301 2302 2303 2333 2334 2337 2338 2349 2350 2351 2352
482 483 486 487
2235 2236 2237 2238 2239
57 59 2256 2257 2258 2259 2337 2338
197 198 205 206 213 214 221 222 229 230 237 238 245 246 253 254 261 262 269 270
2170 2171 2174 2175 2333 2334 2337 2338
1901 1902 1905 1913 1914 1915
57 59 2118 2119 2120 2122 2123 2125 2126 2130 2133 2134 2333 2334 2337 2338 2349 2350 2351 2352
2007 2008 2016 2017
658 659 666 667 674 675 706 708 709 710 711 712 713 1446 1447 1448 1449 1450 1451 1452 1453 1460 1461
495 496 499 500
2615 2616 2617 2619 2620 2621 2622 2623 2624 2625 2626 2627 2631 2632 2639 2640 2641
1568 1569 1576 1577 1584 1585 1592 1593
57 59 2099 2100 2101 2103 2104 2105 2108 2109 2333 2334 2337 2338 2349 2350 2351 2352
26 27 28 30 31 32 33 38 57 59 2615 2616 2617 2619 2620 2621 2622 2623 2631 2636 2639 2640 2641
2197 2198 2201 2202
2087 2088 2091 2333 2334 2337 2338
521 522
2057 2058 2059 2061 2062 2063 2064 2067 2068 2349 2350 2351 2352
57 59 2267 2268 2269 2270 2333 2334 2337 2338
2156 2157 2160 2161 2333 2334 2337 2338
1446 1447 1448 1449 1450 1451 1452 1453 1460 1461 1901 1902 1905 1932 1934 1935 1936 1937 1938 1939
57 59 2223 2224 2225 2226 2227
1492 1493 1500 1501 1508 1509 1516 1517 1524 1525 1532 1533
168 170
2267 2268 2269 2270 2333 2334 2337 2338
1816 1817 1824 1825 1852 1853 1860 1861 1868 1869 1876 1877 1884 1885 1892 1893
